game_id,date,home_team,home_score,away_team,away_score,win_score,lose_score,win_team,lose_team,win_points,lose_points,win_point_diff,lose_point_diff
1,2003-01-23,China PR,0,Germany,0,0,0,China PR,Germany,2119,2162,-43,43
2,2003-01-23,Norway,1,USA,3,3,1,USA,Norway,2171,2165,6,-6
3,2003-01-26,Germany,2,Norway,2,2,2,Germany,Norway,2162,2165,-3,3
4,2003-01-26,China PR,2,USA,0,2,0,China PR,USA,2119,2171,-52,52
5,2003-01-29,USA,1,Germany,0,1,0,USA,Germany,2171,2162,9,-9
6,2003-01-29,China PR,1,Norway,1,1,1,China PR,Norway,2119,2165,-46,46
7,2003-03-14,USA,1,Canada,1,1,1,USA,Canada,2171,1849,322,-322
8,2003-03-14,Sweden,1,Norway,1,1,1,Sweden,Norway,2072,2165,-93,93
9,2003-03-14,Denmark,0,France,3,3,0,France,Denmark,1949,1974,-25,25
10,2003-03-14,China PR,0,Finland,0,0,0,China PR,Finland,2119,1764,355,-355
11,2003-03-14,Portugal,1,Wales,1,1,1,Portugal,Wales,1673,1438,235,-235
12,2003-03-14,Republic of Ireland,0,Greece,0,0,0,Republic of Ireland,Greece,1616,1418,198,-198
13,2003-03-16,Sweden,1,Canada,1,1,1,Sweden,Canada,2072,1849,223,-223
14,2003-03-16,Norway,0,USA,1,1,0,USA,Norway,2171,2165,6,-6
15,2003-03-16,Denmark,0,Finland,0,0,0,Denmark,Finland,1974,1764,210,-210
16,2003-03-16,China PR,3,France,0,3,0,China PR,France,2119,1949,170,-170
17,2003-03-16,Portugal,1,Greece,1,1,1,Portugal,Greece,1673,1418,255,-255
18,2003-03-16,Republic of Ireland,3,Wales,1,3,1,Republic of Ireland,Wales,1616,1438,178,-178
19,2003-03-18,Norway,1,Canada,0,1,0,Norway,Canada,2165,1849,316,-316
20,2003-03-18,USA,1,Sweden,1,1,1,USA,Sweden,2171,2072,99,-99
21,2003-03-18,France,1,Finland,0,1,0,France,Finland,1949,1764,185,-185
22,2003-03-18,China PR,2,Denmark,1,2,1,China PR,Denmark,2119,1974,145,-145
23,2003-03-18,Greece,2,Wales,0,2,0,Greece,Wales,1418,1438,-20,20
24,2003-03-18,Portugal,3,Republic of Ireland,2,3,2,Portugal,Republic of Ireland,1673,1616,57,-57
25,2003-03-20,Republic of Ireland,2,Wales,2,2,2,Republic of Ireland,Wales,1616,1438,178,-178
26,2003-03-20,Portugal,0,Denmark,1,1,0,Denmark,Portugal,1974,1673,301,-301
27,2003-03-20,Canada,7,Greece,1,7,1,Canada,Greece,1849,1418,431,-431
28,2003-03-20,Sweden,5,Finland,0,5,0,Sweden,Finland,2072,1764,308,-308
29,2003-03-20,Norway,1,France,0,1,0,Norway,France,2165,1949,216,-216
30,2003-03-20,USA,2,China PR,0,2,0,USA,China PR,2171,2119,52,-52
31,2003-03-26,Netherlands,0,Spain,1,1,0,Spain,Netherlands,1755,1833,-78,78
32,2003-03-27,Germany,5,Scotland,0,5,0,Germany,Scotland,2162,1672,490,-490
33,2003-03-30,Italy,8,Serbia and Montenegro,0,8,0,Italy,Serbia and Montenegro,1938,1709,229,-229
34,2003-04-05,Cook Islands,1,Papua New Guinea,5,5,1,Papua New Guinea,Cook Islands,0,0,0,0
35,2003-04-05,Australia,19,Samoa,0,19,0,Australia,Samoa,1833,0,1833,-1833
36,2003-04-07,Australia,11,Cook Islands,0,11,0,Australia,Cook Islands,1833,0,1833,-1833
37,2003-04-07,Samoa,0,New Zealand,15,15,0,New Zealand,Samoa,1762,0,1762,-1762
38,2003-04-09,Peru,3,Bolivia,1,3,1,Peru,Bolivia,1609,0,1609,-1609
39,2003-04-09,Ecuador,2,Venezuela,0,2,0,Ecuador,Venezuela,0,0,0,0
40,2003-04-09,Argentina,3,Paraguay,0,3,0,Argentina,Paraguay,1608,1343,265,-265
41,2003-04-09,Cook Islands,0,New Zealand,9,9,0,New Zealand,Cook Islands,1762,0,1762,-1762
42,2003-04-09,Australia,13,Papua New Guinea,0,13,0,Australia,Papua New Guinea,1833,0,1833,-1833
43,2003-04-11,Bolivia,7,Chile,1,7,1,Bolivia,Chile,0,0,0,0
44,2003-04-11,Colombia,8,Venezuela,0,8,0,Colombia,Venezuela,0,0,0,0
45,2003-04-11,Uruguay,1,Paraguay,3,3,1,Paraguay,Uruguay,1343,1363,-20,20
46,2003-04-11,Papua New Guinea,0,New Zealand,5,5,0,New Zealand,Papua New Guinea,1762,0,1762,-1762
47,2003-04-11,Cook Islands,0,Samoa,1,1,0,Samoa,Cook Islands,0,0,0,0
48,2003-04-13,Papua New Guinea,5,Samoa,2,5,2,Papua New Guinea,Samoa,0,0,0,0
49,2003-04-13,Australia,2,New Zealand,0,2,0,Australia,New Zealand,1833,1762,71,-71
50,2003-04-13,Peru,2,Chile,1,2,1,Peru,Chile,1609,0,1609,-1609
51,2003-04-13,Ecuador,1,Colombia,1,1,1,Ecuador,Colombia,0,0,0,0
52,2003-04-13,Argentina,8,Uruguay,0,8,0,Argentina,Uruguay,1608,1363,245,-245
53,2003-04-18,Sweden,6,Switzerland,0,6,0,Sweden,Switzerland,2072,1693,379,-379
54,2003-04-19,Poland,0,Hungary,2,2,0,Hungary,Poland,1723,1684,39,-39
55,2003-04-19,Bosnia and Herzegovina,0,Croatia,1,1,0,Croatia,Bosnia and Herzegovina,1570,1219,351,-351
56,2003-04-23,Brazil,3,Argentina,2,3,2,Brazil,Argentina,2037,1608,429,-429
57,2003-04-23,Peru,0,Colombia,1,1,0,Colombia,Peru,0,1609,-1609,1609
58,2003-04-25,Colombia,2,Argentina,3,3,2,Argentina,Colombia,1608,0,1608,-1608
59,2003-04-25,Peru,0,Brazil,3,3,0,Brazil,Peru,2037,1609,428,-428
60,2003-04-27,Brazil,12,Colombia,0,12,0,Brazil,Colombia,2037,0,2037,-2037
61,2003-04-27,Peru,1,Argentina,1,1,1,Peru,Argentina,1609,1608,1,-1
62,2003-05-10,Ukraine,0,Portugal,1,1,0,Portugal,Ukraine,1673,1806,-133,133
63,2003-05-10,Austria,11,Armenia,0,11,0,Austria,Armenia,1522,0,1522,-1522
64,2003-05-11,Hungary,0,France,4,4,0,France,Hungary,1949,1723,226,-226
65,2003-05-13,Armenia,0,Austria,11,11,0,Austria,Armenia,1522,0,1522,-1522
66,2003-05-15,Norway,2,Netherlands,0,2,0,Norway,Netherlands,2165,1833,332,-332
67,2003-05-17,Sweden,5,Italy,0,5,0,Sweden,Italy,2072,1938,134,-134
68,2003-05-17,Switzerland,1,Serbia and Montenegro,0,1,0,Switzerland,Serbia and Montenegro,1693,1709,-16,16
69,2003-05-17,Belarus,5,Estonia,0,5,0,Belarus,Estonia,1578,1236,342,-342
70,2003-05-18,Russia,6,Poland,0,6,0,Russia,Poland,1896,1684,212,-212
71,2003-05-18,Scotland,5,Ukraine,1,5,1,Scotland,Ukraine,1672,1806,-134,134
72,2003-05-18,Republic of Ireland,6,Bosnia and Herzegovina,0,6,0,Republic of Ireland,Bosnia and Herzegovina,1616,1219,397,-397
73,2003-05-25,Croatia,0,Republic of Ireland,0,0,0,Croatia,Republic of Ireland,1570,1616,-46,46
74,2003-06-01,Finland,1,Switzerland,1,1,1,Finland,Switzerland,1764,1693,71,-71
75,2003-06-07,Portugal,1,Scotland,8,8,1,Scotland,Portugal,1672,1673,-1,1
76,2003-06-08,Ukraine,1,Czech Republic,1,1,1,Ukraine,Czech Republic,1806,1730,76,-76
77,2003-06-08,Thailand,3,Singapore,0,3,0,Thailand,Singapore,1586,1202,384,-384
78,2003-06-08,Korea Republic,8,Hong Kong,0,8,0,Korea Republic,Hong Kong,1697,1364,333,-333
79,2003-06-09,Japan,15,Philippines,0,15,0,Japan,Philippines,1855,1248,607,-607
80,2003-06-09,Guam,1,Chinese Taipei,2,2,1,Chinese Taipei,Guam,1766,1375,391,-391
81,2003-06-09,China PR,6,Vietnam,0,6,0,China PR,Vietnam,2119,1554,565,-565
82,2003-06-09,India,6,Uzbekistan,0,6,0,India,Uzbekistan,1422,1536,-114,114
83,2003-06-10,Thailand,0,Korea Republic,6,6,0,Korea Republic,Thailand,1697,1586,111,-111
84,2003-06-10,Korea DPR,13,Hong Kong,0,13,0,Korea DPR,Hong Kong,1991,1364,627,-627
85,2003-06-11,Philippines,0,Myanmar,6,6,0,Myanmar,Philippines,1519,1248,271,-271
86,2003-06-11,Japan,7,Guam,0,7,0,Japan,Guam,1855,1375,480,-480
87,2003-06-11,Vietnam,4,Uzbekistan,2,4,2,Vietnam,Uzbekistan,1554,1536,18,-18
88,2003-06-11,China PR,12,India,0,12,0,China PR,India,2119,1422,697,-697
89,2003-06-12,Korea Republic,4,Singapore,0,4,0,Korea Republic,Singapore,1697,1202,495,-495
90,2003-06-12,Thailand,0,Korea DPR,14,14,0,Korea DPR,Thailand,1991,1586,405,-405
91,2003-06-13,Philippines,0,Chinese Taipei,4,4,0,Chinese Taipei,Philippines,1766,1248,518,-518
92,2003-06-13,Japan,7,Myanmar,0,7,0,Japan,Myanmar,1855,1519,336,-336
93,2003-06-13,Vietnam,2,India,1,2,1,Vietnam,India,1554,1422,132,-132
94,2003-06-13,China PR,11,Uzbekistan,0,11,0,China PR,Uzbekistan,2119,1536,583,-583
95,2003-06-14,Iceland,4,Hungary,1,4,1,Iceland,Hungary,1777,1723,54,-54
96,2003-06-14,Thailand,3,Hong Kong,1,3,1,Thailand,Hong Kong,1586,1364,222,-222
97,2003-06-14,Korea DPR,16,Singapore,0,16,0,Korea DPR,Singapore,1991,1202,789,-789
98,2003-06-15,Guam,0,Myanmar,4,4,0,Myanmar,Guam,1519,1375,144,-144
99,2003-06-15,Japan,5,Chinese Taipei,0,5,0,Japan,Chinese Taipei,1855,1766,89,-89
100,2003-06-16,Korea DPR,2,Korea Republic,2,2,2,Korea DPR,Korea Republic,1991,1697,294,-294
101,2003-06-16,Hong Kong,1,Singapore,0,1,0,Hong Kong,Singapore,1364,1202,162,-162
102,2003-06-17,Chinese Taipei,1,Myanmar,1,1,1,Chinese Taipei,Myanmar,1766,1519,247,-247
103,2003-06-17,Philippines,2,Guam,1,2,1,Philippines,Guam,1248,1375,-127,127
104,2003-06-19,Korea DPR,3,Japan,0,3,0,Korea DPR,Japan,1991,1855,136,-136
105,2003-06-19,China PR,3,Korea Republic,1,3,1,China PR,Korea Republic,2119,1697,422,-422
106,2003-06-21,Japan,0,Korea Republic,1,1,0,Korea Republic,Japan,1697,1855,-158,158
107,2003-06-21,Korea DPR,2,China PR,1,2,1,Korea DPR,China PR,1991,2119,-128,128
108,2003-06-28,Republic of Ireland,2,Romania,2,2,2,Republic of Ireland,Romania,1616,1645,-29,29
109,2003-07-19,Finland,1,Italy,1,1,1,Finland,Italy,1762,1943,-181,181
110,2003-08-09,Sweden,2,Finland,1,2,1,Sweden,Finland,2074,1762,312,-312
111,2003-08-09,Russia,1,Iceland,1,1,1,Russia,Iceland,1899,1782,117,-117
112,2003-08-09,Ukraine,1,Germany,3,3,1,Germany,Ukraine,2153,1779,374,-374
113,2003-08-10,Romania,3,Malta,0,3,0,Romania,Malta,1650,0,1650,-1650
114,2003-08-10,Estonia,1,Israel,4,4,1,Israel,Estonia,1302,1235,67,-67
115,2003-08-24,Estonia,3,Kazakhstan,2,3,2,Estonia,Kazakhstan,1235,1404,-169,169
116,2003-08-28,Germany,4,Czech Republic,0,4,0,Germany,Czech Republic,2153,1737,416,-416
117,2003-09-08,France,2,Iceland,0,2,0,France,Iceland,1964,1788,176,-176
118,2003-09-08,Hungary,1,Russia,3,3,1,Russia,Hungary,1893,1723,170,-170
119,2003-09-09,Slovakia,5,Armenia,0,5,0,Slovakia,Armenia,1615,1115,500,-500
120,2003-09-11,Norway,1,Denmark,1,1,1,Norway,Denmark,2159,1967,192,-192
121,2003-09-12,Armenia,0,Slovakia,10,10,0,Slovakia,Armenia,1615,1115,500,-500
122,2003-09-13,Iceland,10,Poland,0,10,0,Iceland,Poland,1788,1671,117,-117
123,2003-09-14,Kazakhstan,0,Israel,0,0,0,Kazakhstan,Israel,1404,1312,92,-92
124,2003-09-20,Nigeria,0,Korea DPR,3,3,0,Korea DPR,Nigeria,2004,1740,264,-264
125,2003-09-20,Norway,2,France,0,2,0,Norway,France,2159,1964,195,-195
126,2003-09-20,Germany,4,Canada,1,4,1,Germany,Canada,2155,1870,285,-285
127,2003-09-20,Japan,6,Argentina,0,6,0,Japan,Argentina,1853,1620,233,-233
128,2003-09-21,USA,3,Sweden,1,3,1,USA,Sweden,2171,2073,98,-98
129,2003-09-21,Brazil,3,Korea Republic,0,3,0,Brazil,Korea Republic,2030,1724,306,-306
130,2003-09-21,Australia,1,Russia,2,2,1,Russia,Australia,1893,1839,54,-54
131,2003-09-21,China PR,1,Ghana,0,1,0,China PR,Ghana,2110,1462,648,-648
132,2003-09-24,Bosnia and Herzegovina,1,Malta,0,1,0,Bosnia and Herzegovina,Malta,1217,1304,-87,87
133,2003-09-24,Norway,1,Brazil,4,4,1,Brazil,Norway,2030,2159,-129,129
134,2003-09-24,France,1,Korea Republic,0,1,0,France,Korea Republic,1964,1724,240,-240
135,2003-09-24,Germany,3,Japan,0,3,0,Germany,Japan,2155,1853,302,-302
136,2003-09-24,Canada,3,Argentina,0,3,0,Canada,Argentina,1870,1620,250,-250
137,2003-09-25,Sweden,1,Korea DPR,0,1,0,Sweden,Korea DPR,2073,2004,69,-69
138,2003-09-25,USA,5,Nigeria,0,5,0,USA,Nigeria,2171,1740,431,-431
139,2003-09-25,Ghana,0,Russia,3,3,0,Russia,Ghana,1893,1462,431,-431
140,2003-09-25,China PR,1,Australia,1,1,1,China PR,Australia,2110,1839,271,-271
141,2003-09-27,Switzerland,0,Italy,1,1,0,Italy,Switzerland,1941,1703,238,-238
142,2003-09-27,Serbia and Montenegro,0,Finland,1,1,0,Finland,Serbia and Montenegro,1765,1709,56,-56
143,2003-09-27,Poland,2,Iceland,3,3,2,Iceland,Poland,1788,1671,117,-117
144,2003-09-27,Korea Republic,1,Norway,7,7,1,Norway,Korea Republic,2159,1724,435,-435
145,2003-09-27,France,1,Brazil,1,1,1,France,Brazil,1964,2030,-66,66
146,2003-09-27,Canada,3,Japan,1,3,1,Canada,Japan,1870,1853,17,-17
147,2003-09-27,Argentina,1,Germany,6,6,1,Germany,Argentina,2155,1620,535,-535
148,2003-09-28,Croatia,3,Malta,0,3,0,Croatia,Malta,1568,1304,264,-264
149,2003-09-28,Sweden,3,Nigeria,0,3,0,Sweden,Nigeria,2073,1740,333,-333
150,2003-09-28,USA,3,Korea DPR,0,3,0,USA,Korea DPR,2171,2004,167,-167
151,2003-09-28,Ghana,2,Australia,1,2,1,Ghana,Australia,1462,1839,-377,377
152,2003-09-28,China PR,1,Russia,0,1,0,China PR,Russia,2110,1893,217,-217
153,2003-10-01,Brazil,1,Sweden,2,2,1,Sweden,Brazil,2073,2030,43,-43
154,2003-10-01,USA,1,Norway,0,1,0,USA,Norway,2171,2159,12,-12
155,2003-10-02,Germany,7,Russia,1,7,1,Germany,Russia,2155,1893,262,-262
156,2003-10-02,China PR,0,Canada,1,1,0,Canada,China PR,1870,2110,-240,240
157,2003-10-05,Belgium,1,Denmark,6,6,1,Denmark,Belgium,1967,1717,250,-250
158,2003-10-05,USA,0,Germany,3,3,0,Germany,USA,2155,2171,-16,16
159,2003-10-05,Sweden,2,Canada,1,2,1,Sweden,Canada,2073,1870,203,-203
160,2003-10-11,USA,3,Canada,1,3,1,USA,Canada,2171,1870,301,-301
161,2003-10-12,Romania,2,Bosnia and Herzegovina,0,2,0,Romania,Bosnia and Herzegovina,1650,1217,433,-433
162,2003-10-12,Germany,2,Sweden,1,2,1,Germany,Sweden,2155,2073,82,-82
163,2003-10-18,Denmark,3,Netherlands,0,3,0,Denmark,Netherlands,1967,1814,153,-153
164,2003-10-18,Croatia,2,Romania,3,3,2,Romania,Croatia,1650,1568,82,-82
165,2003-10-18,Belarus,1,Israel,1,1,1,Belarus,Israel,1579,1312,267,-267
166,2003-10-19,Czech Republic,2,Scotland,0,2,0,Czech Republic,Scotland,1737,1693,44,-44
167,2003-10-22,Malta,0,Republic of Ireland,9,9,0,Republic of Ireland,Malta,1613,1304,309,-309
168,2003-10-25,Greece,7,Armenia,0,7,0,Greece,Armenia,1431,1214,217,-217
169,2003-10-28,Armenia,0,Greece,9,9,0,Greece,Armenia,1431,1214,217,-217
170,2003-11-15,Serbia and Montenegro,0,Sweden,4,4,0,Sweden,Serbia and Montenegro,2095,1693,402,-402
171,2003-11-15,France,7,Poland,1,7,1,France,Poland,1967,1661,306,-306
172,2003-11-15,Germany,13,Portugal,0,13,0,Germany,Portugal,2201,1666,535,-535
173,2003-11-15,Greece,3,Slovakia,1,3,1,Greece,Slovakia,1431,1615,-184,184
174,2003-11-16,Spain,0,Norway,2,2,0,Norway,Spain,2131,1767,364,-364
175,2003-11-16,Malta,1,Croatia,4,4,1,Croatia,Malta,1561,1078,483,-483
176,2003-11-20,Norway,6,Belgium,0,6,0,Norway,Belgium,2131,1715,416,-416
177,2003-11-22,Netherlands,3,Belgium,0,3,0,Netherlands,Belgium,1815,1715,100,-100
178,2003-11-29,Greece,0,Austria,2,2,0,Austria,Greece,1522,1431,91,-91
179,2003-12-06,Portugal,0,Czech Republic,1,1,0,Czech Republic,Portugal,1741,1666,75,-75
180,2004-01-30,Sweden,0,USA,3,3,0,USA,Sweden,2162,2097,65,-65
181,2004-01-30,China PR,2,Canada,1,2,1,China PR,Canada,2064,1911,153,-153
182,2004-02-01,Sweden,3,Canada,1,3,1,Sweden,Canada,2097,1911,186,-186
183,2004-02-01,China PR,0,USA,0,0,0,China PR,USA,2064,2162,-98,98
184,2004-02-03,Canada,0,USA,2,2,0,USA,Canada,2162,1911,251,-251
185,2004-02-03,China PR,2,Sweden,2,2,2,China PR,Sweden,2064,2097,-33,33
186,2004-02-07,Portugal,0,Germany,11,11,0,Germany,Portugal,2201,1651,550,-550
187,2004-02-20,Belgium,2,Spain,0,2,0,Belgium,Spain,1711,1765,-54,54
188,2004-02-29,Spain,9,Belgium,1,9,1,Spain,Belgium,1765,1711,54,-54
189,2004-03-07,Belgium,1,Norway,6,6,1,Norway,Belgium,2133,1711,422,-422
190,2004-03-14,Denmark,0,Sweden,1,1,0,Sweden,Denmark,2097,1981,116,-116
191,2004-03-14,USA,5,France,1,5,1,USA,France,2162,1968,194,-194
192,2004-03-14,Norway,4,Finland,1,4,1,Norway,Finland,2133,1773,360,-360
193,2004-03-14,Italy,1,China PR,0,1,0,Italy,China PR,1951,2064,-113,113
194,2004-03-14,Greece,1,Wales,0,1,0,Greece,Wales,1436,1447,-11,11
195,2004-03-14,Portugal,2,Northern Ireland,0,2,0,Portugal,Northern Ireland,1651,1265,386,-386
196,2004-03-16,Denmark,0,USA,1,1,0,USA,Denmark,2167,1977,190,-190
197,2004-03-16,Sweden,0,France,3,3,0,France,Sweden,1964,2094,-130,130
198,2004-03-16,Norway,3,Italy,0,3,0,Norway,Italy,2135,1952,183,-183
199,2004-03-16,Finland,0,China PR,4,4,0,China PR,Finland,2068,1773,295,-295
200,2004-03-16,Northern Ireland,0,Greece,2,2,0,Greece,Northern Ireland,1438,1265,173,-173
201,2004-03-16,Portugal,2,Wales,3,3,2,Wales,Portugal,1447,1650,-203,203
202,2004-03-18,Denmark,0,France,1,1,0,France,Denmark,1964,1977,-13,13
203,2004-03-18,Sweden,3,USA,1,3,1,Sweden,USA,2094,2167,-73,73
204,2004-03-18,Norway,0,China PR,0,0,0,Norway,China PR,2135,2068,67,-67
205,2004-03-18,Finland,1,Italy,2,2,1,Italy,Finland,1952,1773,179,-179
206,2004-03-18,Wales,3,Northern Ireland,1,3,1,Wales,Northern Ireland,1447,1265,182,-182
207,2004-03-18,Portugal,3,Greece,0,3,0,Portugal,Greece,1650,1438,212,-212
208,2004-03-20,Greece,2,Northern Ireland,0,2,0,Greece,Northern Ireland,1438,1265,173,-173
209,2004-03-20,Wales,0,Finland,4,4,0,Finland,Wales,1773,1447,326,-326
210,2004-03-20,Portugal,0,Denmark,1,1,0,Denmark,Portugal,1977,1650,327,-327
211,2004-03-20,Sweden,1,China PR,1,1,1,Sweden,China PR,2094,2068,26,-26
212,2004-03-20,France,3,Italy,3,3,3,France,Italy,1964,1952,12,-12
213,2004-03-20,USA,4,Norway,1,4,1,USA,Norway,2167,2135,32,-32
214,2004-03-21,Spain,0,Netherlands,0,0,0,Spain,Netherlands,1771,1820,-49,49
215,2004-04-03,Portugal,1,Ukraine,2,2,1,Ukraine,Portugal,1778,1650,128,-128
216,2004-04-10,Ukraine,1,Scotland,0,1,0,Ukraine,Scotland,1778,1682,96,-96
217,2004-04-10,Republic of Ireland,8,Croatia,1,8,1,Republic of Ireland,Croatia,1612,1561,51,-51
218,2004-04-18,Spain,0,Denmark,1,1,0,Denmark,Spain,1977,1771,206,-206
219,2004-04-24,Italy,1,Finland,1,1,1,Italy,Finland,1952,1773,179,-179
220,2004-04-24,Switzerland,0,Sweden,2,2,0,Sweden,Switzerland,2094,1697,397,-397
221,2004-04-24,France,6,Hungary,0,6,0,France,Hungary,1964,1717,247,-247
222,2004-04-24,Austria,1,Greece,2,2,1,Greece,Austria,1438,1531,-93,93
223,2004-04-25,Belgium,0,Netherlands,3,3,0,Netherlands,Belgium,1820,1703,117,-117
224,2004-04-28,Germany,6,Ukraine,0,6,0,Germany,Ukraine,2189,1778,411,-411
225,2004-04-29,Slovakia,2,Greece,2,2,2,Slovakia,Greece,1605,1438,167,-167
226,2004-05-01,Hungary,2,Poland,2,2,2,Hungary,Poland,1717,1660,57,-57
227,2004-05-01,Romania,1,Republic of Ireland,1,1,1,Romania,Republic of Ireland,1656,1612,44,-44
228,2004-05-02,Scotland,1,Germany,3,3,1,Germany,Scotland,2189,1682,507,-507
229,2004-05-08,Poland,1,Russia,1,1,1,Poland,Russia,1660,1891,-231,231
230,2004-05-08,Malta,0,Romania,8,8,0,Romania,Malta,1656,1128,528,-528
231,2004-05-08,Austria,3,Slovakia,0,3,0,Austria,Slovakia,1531,1605,-74,74
232,2004-05-09,Czech Republic,5,Portugal,1,5,1,Czech Republic,Portugal,1749,1650,99,-99
233,2004-05-09,Bosnia and Herzegovina,1,Republic of Ireland,4,4,1,Republic of Ireland,Bosnia and Herzegovina,1612,1218,394,-394
234,2004-05-09,Israel,12,Estonia,1,12,1,Israel,Estonia,1324,1234,90,-90
235,2004-05-12,Eritrea,1,Tanzania,1,1,1,Eritrea,Tanzania,0,0,0,0
236,2004-05-15,Finland,4,Serbia and Montenegro,0,4,0,Finland,Serbia and Montenegro,1773,1691,82,-82
237,2004-05-15,Croatia,6,Bosnia and Herzegovina,0,6,0,Croatia,Bosnia and Herzegovina,1561,1218,343,-343
238,2004-05-16,Russia,0,France,3,3,0,France,Russia,1964,1891,73,-73
239,2004-05-22,Italy,0,Switzerland,0,0,0,Italy,Switzerland,1952,1697,255,-255
240,2004-05-22,Denmark,2,Spain,0,2,0,Denmark,Spain,1977,1771,206,-206
241,2004-05-22,Netherlands,0,Norway,2,2,0,Norway,Netherlands,2135,1820,315,-315
242,2004-05-23,Scotland,2,Portugal,1,2,1,Scotland,Portugal,1682,1650,32,-32
243,2004-05-25,Kazakhstan,0,Belarus,2,2,0,Belarus,Kazakhstan,1571,1390,181,-181
244,2004-05-27,Denmark,2,Norway,1,2,1,Denmark,Norway,1977,2135,-158,158
245,2004-05-29,Tanzania,4,Eritrea,0,4,0,Tanzania,Eritrea,0,0,0,0
246,2004-05-29,Hungary,0,Iceland,5,5,0,Iceland,Hungary,1796,1717,79,-79
247,2004-05-30,Equatorial Guinea,2,Congo,2,2,2,Equatorial Guinea,Congo,0,0,0,0
248,2004-05-30,Israel,3,Kazakhstan,1,3,1,Israel,Kazakhstan,1324,1390,-66,66
249,2004-06-02,Iceland,0,France,3,3,0,France,Iceland,1964,1796,168,-168
250,2004-06-05,Czech Republic,4,Ukraine,1,4,1,Czech Republic,Ukraine,1749,1778,-29,29
251,2004-06-12,Congo,2,Equatorial Guinea,0,2,0,Congo,Equatorial Guinea,0,0,0,0
252,2004-06-25,Republic of Ireland,5,Malta,0,5,0,Republic of Ireland,Malta,1623,1127,496,-496
253,2004-06-26,Italy,2,Sweden,1,2,1,Italy,Sweden,1939,2103,-164,164
254,2004-07-10,Senegal,2,Nigeria,8,8,2,Nigeria,Senegal,1720,1092,628,-628
255,2004-07-11,Congo,0,Cameroon,2,2,0,Cameroon,Congo,1217,0,1217,-1217
256,2004-07-11,Malawi,0,Ethiopia,4,4,0,Ethiopia,Malawi,982,0,982,-982
257,2004-07-11,Tanzania,0,Zimbabwe,3,3,0,Zimbabwe,Tanzania,1166,0,1166,-1166
258,2004-07-11,Mali,2,Algeria,2,2,2,Mali,Algeria,1301,1135,166,-166
259,2004-07-11,Guinea,0,Ghana,13,13,0,Ghana,Guinea,1510,0,1510,-1510
260,2004-07-23,Algeria,1,Mali,0,1,0,Algeria,Mali,1135,1301,-166,166
261,2004-07-24,Ghana,9,Guinea,0,9,0,Ghana,Guinea,1510,0,1510,-1510
262,2004-07-24,Nigeria,4,Senegal,11,11,4,Senegal,Nigeria,1092,1720,-628,628
263,2004-07-25,Cameroon,0,Congo,0,0,0,Cameroon,Congo,1217,0,1217,-1217
264,2004-07-25,Ethiopia,5,Malawi,0,5,0,Ethiopia,Malawi,982,0,982,-982
265,2004-07-25,Zimbabwe,4,Tanzania,0,4,0,Zimbabwe,Tanzania,1166,0,1166,-1166
266,2004-08-11,Sweden,0,Japan,1,1,0,Japan,Sweden,1874,2103,-229,229
267,2004-08-11,Germany,8,China PR,0,8,0,Germany,China PR,2191,2068,123,-123
268,2004-08-11,Greece,0,USA,3,3,0,USA,Greece,2166,1462,704,-704
269,2004-08-11,Brazil,1,Australia,0,1,0,Brazil,Australia,2040,1819,221,-221
270,2004-08-14,Japan,0,Nigeria,1,1,0,Nigeria,Japan,1720,1874,-154,154
271,2004-08-14,China PR,1,Mexico,1,1,1,China PR,Mexico,2068,1719,349,-349
272,2004-08-14,Greece,0,Australia,1,1,0,Australia,Greece,1819,1462,357,-357
273,2004-08-14,USA,2,Brazil,0,2,0,USA,Brazil,2166,2040,126,-126
274,2004-08-17,Sweden,2,Nigeria,1,2,1,Sweden,Nigeria,2103,1720,383,-383
275,2004-08-17,Germany,2,Mexico,0,2,0,Germany,Mexico,2191,1719,472,-472
276,2004-08-17,Greece,0,Brazil,7,7,0,Brazil,Greece,2040,1462,578,-578
277,2004-08-17,USA,1,Australia,1,1,1,USA,Australia,2166,1819,347,-347
278,2004-08-20,Germany,2,Nigeria,1,2,1,Germany,Nigeria,2191,1720,471,-471
279,2004-08-20,USA,2,Japan,1,2,1,USA,Japan,2166,1874,292,-292
280,2004-08-20,Mexico,0,Brazil,5,5,0,Brazil,Mexico,2040,1719,321,-321
281,2004-08-20,Sweden,2,Australia,1,2,1,Sweden,Australia,2103,1819,284,-284
282,2004-08-21,Slovakia,2,Austria,3,3,2,Austria,Slovakia,1528,1590,-62,62
283,2004-08-22,Iceland,0,Russia,2,2,0,Russia,Iceland,1880,1800,80,-80
284,2004-08-23,USA,2,Germany,1,2,1,USA,Germany,2166,2191,-25,25
285,2004-08-23,Brazil,1,Sweden,0,1,0,Brazil,Sweden,2040,2103,-63,63
286,2004-08-25,Belarus,8,Kazakhstan,1,8,1,Belarus,Kazakhstan,1577,1384,193,-193
287,2004-08-26,Germany,1,Sweden,0,1,0,Germany,Sweden,2191,2103,88,-88
288,2004-08-26,USA,2,Brazil,1,2,1,USA,Brazil,2166,2040,126,-126
289,2004-08-29,Estonia,1,Belarus,3,3,1,Belarus,Estonia,1577,1229,348,-348
290,2004-09-04,Switzerland,0,Finland,2,2,0,Finland,Switzerland,1786,1699,87,-87
291,2004-09-05,Scotland,3,Czech Republic,2,3,2,Scotland,Czech Republic,1685,1760,-75,75
292,2004-09-05,Malta,0,Bosnia and Herzegovina,2,2,0,Bosnia and Herzegovina,Malta,1215,1127,88,-88
293,2004-09-18,South Africa,0,Ghana,3,3,0,Ghana,South Africa,1511,1372,139,-139
294,2004-09-18,Zimbabwe,1,Ethiopia,1,1,1,Zimbabwe,Ethiopia,1166,982,184,-184
295,2004-09-19,Nigeria,4,Algeria,0,4,0,Nigeria,Algeria,1749,1287,462,-462
296,2004-09-19,Cameroon,2,Mali,2,2,2,Cameroon,Mali,1217,1301,-84,84
297,2004-09-19,Bosnia and Herzegovina,0,Romania,0,0,0,Bosnia and Herzegovina,Romania,1215,1652,-437,437
298,2004-09-19,Kazakhstan,0,Estonia,0,0,0,Kazakhstan,Estonia,1381,1229,152,-152
299,2004-09-21,Ghana,2,Ethiopia,1,2,1,Ghana,Ethiopia,1511,982,529,-529
300,2004-09-21,South Africa,1,Zimbabwe,2,2,1,Zimbabwe,South Africa,1166,1372,-206,206
301,2004-09-22,Algeria,3,Mali,0,3,0,Algeria,Mali,1287,1301,-14,14
302,2004-09-22,Nigeria,2,Cameroon,2,2,2,Nigeria,Cameroon,1749,1217,532,-532
303,2004-09-24,Ghana,2,Zimbabwe,0,2,0,Ghana,Zimbabwe,1511,1166,345,-345
304,2004-09-24,South Africa,1,Ethiopia,2,2,1,Ethiopia,South Africa,982,1372,-390,390
305,2004-09-25,Algeria,1,Cameroon,3,3,1,Cameroon,Algeria,1217,1287,-70,70
306,2004-09-25,Nigeria,3,Mali,0,3,0,Nigeria,Mali,1749,1301,448,-448
307,2004-09-25,Serbia and Montenegro,1,Italy,2,2,1,Italy,Serbia and Montenegro,1948,1679,269,-269
308,2004-09-25,Czech Republic,0,Germany,5,5,0,Germany,Czech Republic,2184,1760,424,-424
309,2004-09-26,Denmark,6,Belgium,0,6,0,Denmark,Belgium,1985,1701,284,-284
310,2004-09-26,France,2,Russia,5,5,2,Russia,France,1893,1992,-99,99
311,2004-09-28,Ghana,0,Cameroon,1,1,0,Cameroon,Ghana,1217,1511,-294,294
312,2004-09-28,Nigeria,4,Ethiopia,0,4,0,Nigeria,Ethiopia,1749,982,767,-767
313,2004-09-29,Serbia and Montenegro,1,Switzerland,0,1,0,Serbia and Montenegro,Switzerland,1679,1699,-20,20
314,2004-09-29,Netherlands,1,Denmark,5,5,1,Denmark,Netherlands,1985,1821,164,-164
315,2004-10-02,Ghana,0,Ethiopia,0,0,0,Ghana,Ethiopia,1511,982,529,-529
316,2004-10-02,Finland,1,Sweden,1,1,1,Finland,Sweden,1786,2039,-253,253
317,2004-10-02,Norway,2,Spain,0,2,0,Norway,Spain,2145,1756,389,-389
318,2004-10-02,Romania,10,Croatia,0,10,0,Romania,Croatia,1652,1557,95,-95
319,2004-10-02,Israel,0,Belarus,2,2,0,Belarus,Israel,1580,1336,244,-244
320,2004-10-03,Nigeria,5,Cameroon,0,5,0,Nigeria,Cameroon,1749,1217,532,-532
321,2004-10-03,Russia,4,Hungary,0,4,0,Russia,Hungary,1893,1701,192,-192
322,2004-10-03,Poland,1,France,5,5,1,France,Poland,1992,1664,328,-328
323,2004-10-16,Finland,1,Russia,0,1,0,Finland,Russia,1786,1893,-107,107
324,2004-10-20,Russia,1,Finland,3,3,1,Finland,Russia,1786,1893,-107,107
325,2004-11-10,Iceland,2,Norway,7,7,2,Norway,Iceland,2145,1791,354,-354
326,2004-11-13,Italy,2,Czech Republic,1,2,1,Italy,Czech Republic,1948,1760,188,-188
327,2004-11-13,Norway,2,Iceland,1,2,1,Norway,Iceland,2145,1791,354,-354
328,2004-11-27,Czech Republic,0,Italy,3,3,0,Italy,Czech Republic,1948,1760,188,-188
329,2004-12-20,Sweden,5,Serbia and Montenegro,1,5,1,Sweden,Serbia and Montenegro,2039,1679,360,-360
329,2004-12-20,Sweden,5,Serbia and Montenegro,1,5,1,Sweden,Serbia and Montenegro,2035,1679,356,-356
330,2005-01-28,Germany,0,Australia,1,1,0,Australia,Germany,1844,2181,-337,337
331,2005-01-28,China PR,3,Russia,1,3,1,China PR,Russia,2025,1889,136,-136
332,2005-01-30,China PR,3,Australia,0,3,0,China PR,Australia,2025,1844,181,-181
333,2005-01-30,Germany,1,Russia,0,1,0,Germany,Russia,2181,1889,292,-292
334,2005-02-01,Russia,0,Australia,5,5,0,Australia,Russia,1844,1889,-45,45
335,2005-02-01,China PR,0,Germany,2,2,0,Germany,China PR,2181,2025,156,-156
336,2005-03-09,Norway,2,China PR,1,2,1,Norway,China PR,2146,2025,121,-121
337,2005-03-09,Sweden,1,Germany,2,2,1,Germany,Sweden,2181,2035,146,-146
338,2005-03-09,Denmark,4,Finland,1,4,1,Denmark,Finland,2000,1819,181,-181
339,2005-03-09,France,0,USA,1,1,0,USA,France,2165,1986,179,-179
340,2005-03-09,England,4,Northern Ireland,0,4,0,England,Northern Ireland,1866,1260,606,-606
341,2005-03-09,Portugal,1,Mexico,2,2,1,Mexico,Portugal,1729,1631,98,-98
342,2005-03-11,China PR,0,Sweden,2,2,0,Sweden,China PR,2035,2025,10,-10
343,2005-03-11,Germany,4,Norway,0,4,0,Germany,Norway,2181,2146,35,-35
344,2005-03-11,USA,3,Finland,0,3,0,USA,Finland,2165,1819,346,-346
345,2005-03-11,Denmark,1,France,2,2,1,France,Denmark,1986,2000,-14,14
346,2005-03-11,Portugal,0,England,4,4,0,England,Portugal,1866,1631,235,-235
347,2005-03-11,Mexico,2,Northern Ireland,0,2,0,Mexico,Northern Ireland,1729,1260,469,-469
348,2005-03-13,China PR,0,Germany,2,2,0,Germany,China PR,2181,2025,156,-156
349,2005-03-13,Sweden,1,Norway,1,1,1,Sweden,Norway,2035,2146,-111,111
350,2005-03-13,USA,4,Denmark,0,4,0,USA,Denmark,2165,2000,165,-165
351,2005-03-13,Finland,1,France,2,2,1,France,Finland,1986,1819,167,-167
352,2005-03-13,England,5,Mexico,0,5,0,England,Mexico,1866,1729,137,-137
353,2005-03-13,Portugal,1,Northern Ireland,2,2,1,Northern Ireland,Portugal,1260,1631,-371,371
354,2005-03-15,Portugal,3,Northern Ireland,1,3,1,Portugal,Northern Ireland,1631,1260,371,-371
355,2005-03-15,Finland,1,Mexico,1,1,1,Finland,Mexico,1819,1729,90,-90
356,2005-03-15,China PR,0,England,0,0,0,China PR,England,2025,1866,159,-159
357,2005-03-15,Norway,2,Denmark,1,2,1,Norway,Denmark,2146,2000,146,-146
358,2005-03-15,Sweden,2,France,3,3,2,France,Sweden,1986,2035,-49,49
359,2005-03-15,Germany,0,USA,1,1,0,USA,Germany,2165,2181,-16,16
360,2005-05-06,Uzbekistan,1,Myanmar,2,2,1,Myanmar,Uzbekistan,1544,1505,39,-39
361,2005-05-06,Thailand,3,India,2,3,2,Thailand,India,1584,1436,148,-148
362,2005-06-05,Sweden,1,Denmark,1,1,1,Sweden,Denmark,2034,1989,45,-45
363,2005-06-05,England,3,Finland,2,3,2,England,Finland,1879,1816,63,-63
364,2005-06-06,Germany,1,Norway,0,1,0,Germany,Norway,2190,2109,81,-81
365,2005-06-06,France,3,Italy,1,3,1,France,Italy,2038,1952,86,-86
366,2005-06-08,England,1,Denmark,2,2,1,Denmark,England,1989,1879,110,-110
367,2005-06-08,Sweden,0,Finland,0,0,0,Sweden,Finland,2034,1816,218,-218
368,2005-06-09,Germany,4,Italy,0,4,0,Germany,Italy,2190,1952,238,-238
369,2005-06-09,Norway,1,France,1,1,1,Norway,France,2109,2038,71,-71
370,2005-06-11,England,0,Sweden,1,1,0,Sweden,England,2034,1879,155,-155
371,2005-06-11,Finland,2,Denmark,1,2,1,Finland,Denmark,1816,1989,-173,173
372,2005-06-12,France,0,Germany,3,3,0,Germany,France,2190,2038,152,-152
373,2005-06-12,Norway,5,Italy,3,5,3,Norway,Italy,2109,1952,157,-157
374,2005-06-12,Vietnam,6,Philippines,1,6,1,Vietnam,Philippines,1577,1270,307,-307
375,2005-06-12,India,10,Guam,0,10,0,India,Guam,1436,1338,98,-98
376,2005-06-13,Uzbekistan,6,Maldives,0,6,0,Uzbekistan,Maldives,1505,1151,354,-354
377,2005-06-13,Indonesia,0,Singapore,0,0,0,Indonesia,Singapore,1389,1198,191,-191
378,2005-06-14,Myanmar,4,Philippines,1,4,1,Myanmar,Philippines,1544,1270,274,-274
379,2005-06-14,Chinese Taipei,2,India,1,2,1,Chinese Taipei,India,1739,1436,303,-303
380,2005-06-15,Germany,4,Finland,1,4,1,Germany,Finland,2190,1816,374,-374
381,2005-06-15,Uzbekistan,3,Hong Kong,0,3,0,Uzbekistan,Hong Kong,1505,1363,142,-142
382,2005-06-15,Thailand,5,Singapore,1,5,1,Thailand,Singapore,1584,1198,386,-386
383,2005-06-16,Sweden,2,Norway,3,3,2,Norway,Sweden,2109,2034,75,-75
384,2005-06-16,Vietnam,1,Myanmar,0,1,0,Vietnam,Myanmar,1577,1544,33,-33
385,2005-06-16,Chinese Taipei,11,Guam,0,11,0,Chinese Taipei,Guam,1739,1338,401,-401
386,2005-06-17,Hong Kong,4,Maldives,0,4,0,Hong Kong,Maldives,1363,1151,212,-212
387,2005-06-17,Thailand,4,Indonesia,0,4,0,Thailand,Indonesia,1584,1389,195,-195
388,2005-06-19,Germany,3,Norway,1,3,1,Germany,Norway,2190,2109,81,-81
389,2005-06-19,Vietnam,4,Hong Kong,1,4,1,Vietnam,Hong Kong,1577,1363,214,-214
390,2005-06-19,Chinese Taipei,3,Singapore,0,3,0,Chinese Taipei,Singapore,1739,1198,541,-541
391,2006-01-18,Norway,1,USA,3,3,1,USA,Norway,2184,2100,84,-84
392,2006-01-18,China PR,1,France,1,1,1,China PR,France,1950,1997,-47,47
393,2006-01-20,USA,0,France,0,0,0,USA,France,2184,1997,187,-187
394,2006-01-20,China PR,3,Norway,1,3,1,China PR,Norway,1950,2100,-150,150
395,2006-01-22,France,1,Norway,1,1,1,France,Norway,1997,2100,-103,103
396,2006-01-22,China PR,0,USA,2,2,0,USA,China PR,2184,1950,234,-234
397,2006-02-19,Benin,1,Malawi,0,1,0,Benin,Malawi,0,0,0,0
398,2006-02-19,Mozambique,9,Namibia,0,9,0,Mozambique,Namibia,923,970,-47,47
399,2006-02-26,Malawi,0,Benin,0,0,0,Malawi,Benin,0,0,0,0
400,2006-03-09,Germany,5,Finland,0,5,0,Germany,Finland,2234,1845,389,-389
401,2006-03-09,Norway,0,Sweden,0,0,0,Norway,Sweden,2100,2012,88,-88
402,2006-03-09,China PR,0,USA,0,0,0,China PR,USA,1950,2184,-234,234
403,2006-03-09,Denmark,2,France,2,2,2,Denmark,France,1977,1997,-20,20
404,2006-03-09,Portugal,0,Republic of Ireland,1,1,0,Republic of Ireland,Portugal,1632,1592,40,-40
405,2006-03-11,Morocco,0,Mali,2,2,0,Mali,Morocco,1283,1462,-179,179
406,2006-03-11,South Africa,6,Mozambique,2,6,2,South Africa,Mozambique,1325,923,402,-402
407,2006-03-11,Congo DR,3,Zambia,0,3,0,Congo DR,Zambia,1172,1027,145,-145
408,2006-03-11,Sweden,0,Germany,3,3,0,Germany,Sweden,2234,2012,222,-222
409,2006-03-11,Finland,0,Norway,0,0,0,Finland,Norway,1845,2100,-255,255
410,2006-03-11,France,1,China PR,0,1,0,France,China PR,1997,1950,47,-47
411,2006-03-11,Denmark,0,USA,5,5,0,USA,Denmark,2184,1977,207,-207
412,2006-03-11,Republic of Ireland,0,Mexico,0,0,0,Republic of Ireland,Mexico,1632,1729,-97,97
413,2006-03-12,Barbados,0,Antigua and Barbuda,1,1,0,Antigua and Barbuda,Barbados,0,979,-979,979
414,2006-03-12,Benin,1,Côte d'Ivoire,1,1,1,Benin,Côte d'Ivoire,0,0,0,0
415,2006-03-12,Angola,3,Equatorial Guinea,2,3,2,Angola,Equatorial Guinea,1191,0,1191,-1191
416,2006-03-12,Congo,9,Togo,0,9,0,Congo,Togo,1056,962,94,-94
417,2006-03-12,Senegal,7,Guinea,0,7,0,Senegal,Guinea,1184,1084,100,-100
418,2006-03-13,Sweden,4,Finland,1,4,1,Sweden,Finland,2012,1845,167,-167
419,2006-03-13,Germany,1,Norway,0,1,0,Germany,Norway,2234,2100,134,-134
420,2006-03-13,USA,4,France,1,4,1,USA,France,2184,1997,187,-187
421,2006-03-13,Denmark,0,China PR,6,6,0,China PR,Denmark,1950,1977,-27,27
422,2006-03-13,Portugal,0,Mexico,6,6,0,Mexico,Portugal,1729,1592,137,-137
423,2006-03-15,Denmark,4,Republic of Ireland,0,4,0,Denmark,Republic of Ireland,1977,1632,345,-345
424,2006-03-15,Finland,4,Mexico,3,4,3,Finland,Mexico,1845,1729,116,-116
425,2006-03-15,Norway,1,China PR,0,1,0,Norway,China PR,2100,1950,150,-150
426,2006-03-15,Sweden,1,France,0,1,0,Sweden,France,2012,1997,15,-15
427,2006-03-15,Germany,0,USA,0,0,0,Germany,USA,2234,2184,50,-50
428,2006-03-18,Antigua and Barbuda,0,Barbados,0,0,0,Antigua and Barbuda,Barbados,0,979,-979,979
429,2006-03-18,Cayman Islands,1,Netherlands Antilles,2,2,1,Netherlands Antilles,Cayman Islands,831,917,-86,86
430,2006-03-25,Mali,4,Morocco,1,4,1,Mali,Morocco,1306,1439,-133,133
431,2006-03-25,Côte d'Ivoire,1,Benin,1,1,1,Côte d'Ivoire,Benin,0,0,0,0
432,2006-03-25,Kenya,7,Djibouti,0,7,0,Kenya,Djibouti,0,NA,NA,NA
433,2006-03-25,Zambia,2,Congo DR,3,3,2,Congo DR,Zambia,1172,952,220,-220
434,2006-03-25,Netherlands Antilles,1,Cayman Islands,0,1,0,Netherlands Antilles,Cayman Islands,831,917,-86,86
435,2006-03-26,Equatorial Guinea,3,Angola,1,3,1,Equatorial Guinea,Angola,953,1191,-238,238
436,2006-03-26,Mozambique,1,South Africa,6,6,1,South Africa,Mozambique,1325,907,418,-418
437,2006-03-26,Togo,1,Congo,3,3,1,Congo,Togo,1056,962,94,-94
438,2006-03-26,Guinea,1,Senegal,5,5,1,Senegal,Guinea,1285,1084,201,-201
439,2006-04-01,British Virgin Islands,1,US Virgin Islands,3,3,1,US Virgin Islands,British Virgin Islands,0,0,0,0
440,2006-04-09,US Virgin Islands,5,British Virgin Islands,0,5,0,US Virgin Islands,British Virgin Islands,0,0,0,0
441,2006-05-03,Suriname,7,Netherlands Antilles,1,7,1,Suriname,Netherlands Antilles,1199,831,368,-368
442,2006-05-04,Dominican Republic,3,US Virgin Islands,1,3,1,Dominican Republic,US Virgin Islands,1114,0,1114,-1114
443,2006-05-04,Bermuda,4,Turks and Caicos Islands,0,4,0,Bermuda,Turks and Caicos Islands,974,704,270,-270
444,2006-05-05,Aruba,1,Netherlands Antilles,2,2,1,Netherlands Antilles,Aruba,831,0,831,-831
445,2006-05-06,Bermuda,4,US Virgin Islands,1,4,1,Bermuda,US Virgin Islands,974,0,974,-974
446,2006-05-06,Dominican Republic,5,Turks and Caicos Islands,0,5,0,Dominican Republic,Turks and Caicos Islands,1114,704,410,-410
447,2006-05-07,Aruba,0,Suriname,3,3,0,Suriname,Aruba,1199,0,1199,-1199
448,2006-05-08,US Virgin Islands,2,Turks and Caicos Islands,0,2,0,US Virgin Islands,Turks and Caicos Islands,0,704,-704,704
449,2006-05-08,Dominican Republic,3,Bermuda,1,3,1,Dominican Republic,Bermuda,1114,974,140,-140
450,2006-05-08,St Kitts and Nevis,3,Antigua and Barbuda,2,3,2,St Kitts and Nevis,Antigua and Barbuda,0,0,0,0
451,2006-05-08,Jamaica,5,St Lucia,0,5,0,Jamaica,St Lucia,1294,1158,136,-136
452,2006-05-10,St Lucia,3,St Kitts and Nevis,2,3,2,St Lucia,St Kitts and Nevis,1158,0,1158,-1158
453,2006-05-10,Jamaica,10,Antigua and Barbuda,0,10,0,Jamaica,Antigua and Barbuda,1294,0,1294,-1294
454,2006-05-10,Mexico,9,Nicaragua,0,9,0,Mexico,Nicaragua,1726,1113,613,-613
455,2006-05-12,Antigua and Barbuda,1,St Lucia,2,2,1,St Lucia,Antigua and Barbuda,1158,0,1158,-1158
456,2006-05-12,Jamaica,11,St Kitts and Nevis,0,11,0,Jamaica,St Kitts and Nevis,1294,0,1294,-1294
457,2006-05-12,Nicaragua,2,El Salvador,1,2,1,Nicaragua,El Salvador,1113,1160,-47,47
458,2006-05-14,Mexico,8,El Salvador,0,8,0,Mexico,El Salvador,1726,1160,566,-566
459,2006-05-19,St Vincent and the Grenadines,2,Dominica,0,2,0,St Vincent and the Grenadines,Dominica,1138,1199,-61,61
459,2006-05-19,St Vincent and the Grenadines,2,Dominica,0,2,0,St Vincent and the Grenadines,Dominica,1138,1199,-61,61
460,2006-05-19,Trinidad and Tobago,10,Grenada,0,10,0,Trinidad and Tobago,Grenada,1593,0,1593,-1593
460,2006-05-19,Trinidad and Tobago,10,Grenada,0,10,0,Trinidad and Tobago,Grenada,1593,0,1593,-1593
461,2006-05-21,Dominica,2,Grenada,2,2,2,Dominica,Grenada,1199,0,1199,-1199
462,2006-05-21,Trinidad and Tobago,4,St Vincent and the Grenadines,1,4,1,Trinidad and Tobago,St Vincent and the Grenadines,1593,1138,455,-455
463,2006-05-23,Grenada,0,St Vincent and the Grenadines,5,5,0,St Vincent and the Grenadines,Grenada,1138,0,1138,-1138
464,2006-05-23,Trinidad and Tobago,6,Dominica,0,6,0,Trinidad and Tobago,Dominica,1593,1199,394,-394
465,2006-05-24,Guatemala,2,Costa Rica,1,2,1,Guatemala,Costa Rica,1287,1547,-260,260
466,2006-05-26,Panama,2,Costa Rica,0,2,0,Panama,Costa Rica,1375,1547,-172,172
467,2006-05-28,Panama,3,Guatemala,0,3,0,Panama,Guatemala,1375,1287,88,-88
468,2006-05-29,Suriname,0,Haiti,3,3,0,Haiti,Suriname,1443,1199,244,-244
469,2006-07-16,Myanmar,1,Thailand,2,2,1,Thailand,Myanmar,1591,1566,25,-25
470,2006-07-16,Australia,4,Korea Republic,0,4,0,Australia,Korea Republic,1866,1748,118,-118
471,2006-07-18,Thailand,0,Korea DPR,9,9,0,Korea DPR,Thailand,1999,1591,408,-408
472,2006-07-18,Australia,2,Myanmar,0,2,0,Australia,Myanmar,1866,1566,300,-300
473,2006-07-19,China PR,2,Chinese Taipei,0,2,0,China PR,Chinese Taipei,1981,1733,248,-248
474,2006-07-19,Japan,5,Vietnam,0,5,0,Japan,Vietnam,1907,1605,302,-302
475,2006-07-20,Korea DPR,3,Myanmar,0,3,0,Korea DPR,Myanmar,1999,1566,433,-433
476,2006-07-20,Korea Republic,11,Thailand,0,11,0,Korea Republic,Thailand,1748,1591,157,-157
477,2006-07-21,Japan,11,Chinese Taipei,1,11,1,Japan,Chinese Taipei,1907,1733,174,-174
478,2006-07-21,Vietnam,0,China PR,2,2,0,China PR,Vietnam,1981,1605,376,-376
479,2006-07-22,Mali,3,Benin,1,3,1,Mali,Benin,1321,0,1321,-1321
480,2006-07-22,Cameroon,4,Kenya,0,4,0,Cameroon,Kenya,1268,0,1268,-1268
481,2006-07-22,Korea Republic,3,Myanmar,1,3,1,Korea Republic,Myanmar,1748,1566,182,-182
482,2006-07-22,Australia,0,Korea DPR,0,0,0,Australia,Korea DPR,1866,1999,-133,133
483,2006-07-23,Algeria,1,Egypt,0,1,0,Algeria,Egypt,1295,1323,-28,28
484,2006-07-23,South Africa,3,Tanzania,0,3,0,South Africa,Tanzania,1325,788,537,-537
485,2006-07-23,Congo DR,3,Senegal,0,3,0,Congo DR,Senegal,1172,1295,-123,123
486,2006-07-23,China PR,0,Japan,1,1,0,Japan,China PR,1907,1981,-74,74
487,2006-07-23,Chinese Taipei,0,Vietnam,1,1,0,Vietnam,Chinese Taipei,1605,1733,-128,128
488,2006-07-24,Australia,5,Thailand,0,5,0,Australia,Thailand,1866,1591,275,-275
489,2006-07-24,Korea DPR,1,Korea Republic,0,1,0,Korea DPR,Korea Republic,1999,1748,251,-251
490,2006-07-27,Australia,2,Japan,0,2,0,Australia,Japan,1866,1907,-41,41
491,2006-07-27,China PR,1,Korea DPR,0,1,0,China PR,Korea DPR,1981,1999,-18,18
492,2006-07-30,Japan,2,Korea DPR,3,3,2,Korea DPR,Japan,1999,1907,92,-92
493,2006-07-30,Australia,2,China PR,2,2,2,Australia,China PR,1866,1981,-115,115
494,2006-08-04,Tanzania,0,South Africa,4,4,0,South Africa,Tanzania,1325,788,537,-537
495,2006-08-05,Egypt,0,Algeria,3,3,0,Algeria,Egypt,1295,1323,-28,28
496,2006-08-05,Kenya,0,Cameroon,5,5,0,Cameroon,Kenya,1268,0,1268,-1268
497,2006-08-05,Senegal,2,Congo DR,0,2,0,Senegal,Congo DR,1295,1172,123,-123
498,2006-08-06,Benin,0,Mali,1,1,0,Mali,Benin,1321,0,1321,-1321
499,2006-09-06,Trinidad and Tobago,5,Suriname,1,5,1,Trinidad and Tobago,Suriname,1593,1199,394,-394
500,2006-09-06,Jamaica,7,Bermuda,0,7,0,Jamaica,Bermuda,1294,974,320,-320
501,2006-09-08,Suriname,0,Dominican Republic,2,2,0,Dominican Republic,Suriname,1114,1199,-85,85
502,2006-09-08,Bermuda,0,Haiti,5,5,0,Haiti,Bermuda,1443,974,469,-469
503,2006-09-10,Trinidad and Tobago,7,Dominican Republic,0,7,0,Trinidad and Tobago,Dominican Republic,1593,1114,479,-479
504,2006-09-10,Haiti,0,Jamaica,3,3,0,Jamaica,Haiti,1294,1443,-149,149
505,2006-10-28,South Africa,4,Algeria,0,4,0,South Africa,Algeria,1332,1321,11,-11
506,2006-10-28,Nigeria,4,Equatorial Guinea,2,4,2,Nigeria,Equatorial Guinea,1736,1219,517,-517
507,2006-10-29,Mali,0,Ghana,1,1,0,Ghana,Mali,1494,1312,182,-182
508,2006-10-29,Cameroon,1,Congo DR,1,1,1,Cameroon,Congo DR,1268,1182,86,-86
509,2006-10-31,Nigeria,6,Algeria,0,6,0,Nigeria,Algeria,1736,1321,415,-415
510,2006-10-31,Equatorial Guinea,0,South Africa,2,2,0,South Africa,Equatorial Guinea,1332,1219,113,-113
511,2006-11-01,Ghana,2,Cameroon,1,2,1,Ghana,Cameroon,1494,1268,226,-226
512,2006-11-01,Mali,3,Congo DR,2,3,2,Mali,Congo DR,1312,1182,130,-130
513,2006-11-03,Equatorial Guinea,3,Algeria,3,3,3,Equatorial Guinea,Algeria,1219,1321,-102,102
514,2006-11-03,Nigeria,2,South Africa,0,2,0,Nigeria,South Africa,1736,1332,404,-404
515,2006-11-04,Congo DR,1,Ghana,3,3,1,Ghana,Congo DR,1494,1182,312,-312
516,2006-11-04,Cameroon,2,Mali,0,2,0,Cameroon,Mali,1268,1312,-44,44
517,2006-11-07,Nigeria,5,Cameroon,0,5,0,Nigeria,Cameroon,1736,1268,468,-468
518,2006-11-07,Ghana,1,South Africa,0,1,0,Ghana,South Africa,1494,1332,162,-162
519,2006-11-10,Cameroon,2,South Africa,24,24,2,South Africa,Cameroon,1332,1268,64,-64
520,2006-11-10,Chile,1,Ecuador,2,2,1,Ecuador,Chile,1463,1487,-24,24
521,2006-11-10,Argentina,2,Uruguay,1,2,1,Argentina,Uruguay,1604,1347,257,-257
522,2006-11-11,Nigeria,1,Ghana,0,1,0,Nigeria,Ghana,1736,1494,242,-242
523,2006-11-11,Bolivia,1,Venezuela,1,1,1,Bolivia,Venezuela,1220,1282,-62,62
524,2006-11-11,Paraguay,1,Brazil,4,4,1,Brazil,Paraguay,2053,1354,699,-699
525,2006-11-12,Colombia,1,Uruguay,0,1,0,Colombia,Uruguay,1600,1347,253,-253
526,2006-11-12,Argentina,8,Chile,0,8,0,Argentina,Chile,1604,1487,117,-117
527,2006-11-13,Peru,0,Brazil,2,2,0,Brazil,Peru,2053,1627,426,-426
528,2006-11-13,Bolivia,1,Paraguay,5,5,1,Paraguay,Bolivia,1354,1220,134,-134
529,2006-11-14,Argentina,1,Ecuador,0,1,0,Argentina,Ecuador,1604,1463,141,-141
530,2006-11-14,Colombia,1,Chile,3,3,1,Chile,Colombia,1487,1600,-113,113
531,2006-11-15,Venezuela,1,Paraguay,3,3,1,Paraguay,Venezuela,1354,1282,72,-72
532,2006-11-15,Peru,2,Bolivia,1,2,1,Peru,Bolivia,1627,1220,407,-407
533,2006-11-16,Uruguay,2,Chile,1,2,1,Uruguay,Chile,1347,1487,-140,140
534,2006-11-16,Ecuador,2,Colombia,2,2,2,Ecuador,Colombia,1463,1600,-137,137
535,2006-11-17,Brazil,6,Bolivia,1,6,1,Brazil,Bolivia,2053,1220,833,-833
536,2006-11-17,Venezuela,2,Peru,0,2,0,Venezuela,Peru,1282,1627,-345,345
537,2006-11-18,Argentina,6,Colombia,0,6,0,Argentina,Colombia,1604,1600,4,-4
538,2006-11-18,Uruguay,1,Ecuador,0,1,0,Uruguay,Ecuador,1347,1463,-116,116
539,2006-11-18,Croatia,6,Georgia,0,6,0,Croatia,Georgia,1493,0,1493,-1493
540,2006-11-18,Turkey,1,Northern Ireland,0,1,0,Turkey,Northern Ireland,1344,1303,41,-41
541,2006-11-18,Israel,3,Latvia,0,3,0,Israel,Latvia,1357,1367,-10,10
542,2006-11-18,Bosnia and Herzegovina,1,Armenia,1,1,1,Bosnia and Herzegovina,Armenia,1231,1064,167,-167
543,2006-11-18,Luxembourg,0,Slovakia,4,4,0,Slovakia,Luxembourg,1599,0,1599,-1599
544,2006-11-18,Malta,0,Lithuania,0,0,0,Malta,Lithuania,1108,1399,-291,291
545,2006-11-18,Romania,4,Azerbaijan,1,4,1,Romania,Azerbaijan,1601,0,1601,-1601
546,2006-11-18,Estonia,0,Bulgaria,5,5,0,Bulgaria,Estonia,1529,1244,285,-285
547,2006-11-18,Wales,2,Faroe Islands,1,2,1,Wales,Faroe Islands,1459,1334,125,-125
548,2006-11-18,FYR Macedonia,0,Kazakhstan,1,1,0,Kazakhstan,FYR Macedonia,1362,939,423,-423
549,2006-11-19,Paraguay,2,Peru,1,2,1,Paraguay,Peru,1354,1627,-273,273
550,2006-11-19,Brazil,6,Venezuela,0,6,0,Brazil,Venezuela,2053,1282,771,-771
551,2006-11-19,Jamaica,2,Panama,0,2,0,Jamaica,Panama,1294,1396,-102,102
552,2006-11-19,Mexico,3,Trinidad and Tobago,0,3,0,Mexico,Trinidad and Tobago,1724,1593,131,-131
553,2006-11-20,Turkey,1,Croatia,2,2,1,Croatia,Turkey,1493,1344,149,-149
554,2006-11-20,Georgia,0,Northern Ireland,4,4,0,Northern Ireland,Georgia,1303,0,1303,-1303
555,2006-11-20,Israel,1,Armenia,0,1,0,Israel,Armenia,1357,1064,293,-293
556,2006-11-20,Bosnia and Herzegovina,4,Latvia,1,4,1,Bosnia and Herzegovina,Latvia,1231,1367,-136,136
557,2006-11-20,Slovakia,3,Lithuania,0,3,0,Slovakia,Lithuania,1599,1399,200,-200
558,2006-11-20,Luxembourg,4,Malta,2,4,2,Luxembourg,Malta,0,1108,-1108,1108
559,2006-11-20,Azerbaijan,3,Estonia,2,3,2,Azerbaijan,Estonia,0,1244,-1244,1244
560,2006-11-20,Romania,1,Bulgaria,0,1,0,Romania,Bulgaria,1601,1529,72,-72
561,2006-11-20,FYR Macedonia,0,Wales,6,6,0,Wales,FYR Macedonia,1459,939,520,-520
562,2006-11-20,Faroe Islands,0,Kazakhstan,1,1,0,Kazakhstan,Faroe Islands,1362,1334,28,-28
563,2006-11-22,Argentina,0,Paraguay,0,0,0,Argentina,Paraguay,1604,1354,250,-250
564,2006-11-22,Brazil,6,Uruguay,0,6,0,Brazil,Uruguay,2053,1347,706,-706
565,2006-11-22,Canada,4,Jamaica,0,4,0,Canada,Jamaica,1932,1294,638,-638
566,2006-11-22,USA,2,Mexico,0,2,0,USA,Mexico,2201,1724,477,-477
567,2006-11-23,Northern Ireland,5,Croatia,1,5,1,Northern Ireland,Croatia,1303,1493,-190,190
568,2006-11-23,Turkey,9,Georgia,0,9,0,Turkey,Georgia,1344,0,1344,-1344
569,2006-11-23,Bosnia and Herzegovina,2,Israel,5,5,2,Israel,Bosnia and Herzegovina,1357,1231,126,-126
570,2006-11-23,Armenia,1,Latvia,0,1,0,Armenia,Latvia,1064,1367,-303,303
571,2006-11-23,Malta,0,Slovakia,8,8,0,Slovakia,Malta,1599,1108,491,-491
572,2006-11-23,Luxembourg,1,Lithuania,1,1,1,Luxembourg,Lithuania,0,1399,-1399,1399
573,2006-11-23,Romania,5,Estonia,0,5,0,Romania,Estonia,1601,1244,357,-357
574,2006-11-23,Bulgaria,3,Azerbaijan,0,3,0,Bulgaria,Azerbaijan,1529,0,1529,-1529
575,2006-11-23,Kazakhstan,1,Wales,2,2,1,Wales,Kazakhstan,1459,1362,97,-97
576,2006-11-23,FYR Macedonia,0,Faroe Islands,7,7,0,Faroe Islands,FYR Macedonia,1334,939,395,-395
577,2006-11-24,Argentina,2,Uruguay,0,2,0,Argentina,Uruguay,1604,1347,257,-257
578,2006-11-24,Brazil,6,Paraguay,0,6,0,Brazil,Paraguay,2053,1354,699,-699
579,2006-11-26,Uruguay,3,Paraguay,2,3,2,Uruguay,Paraguay,1347,1354,-7,7
580,2006-11-26,Argentina,2,Brazil,0,2,0,Argentina,Brazil,1604,2053,-449,449
581,2006-11-26,Jamaica,0,Mexico,3,3,0,Mexico,Jamaica,1724,1294,430,-430
582,2006-11-26,USA,2,Canada,1,2,1,USA,Canada,2201,1932,269,-269
583,2007-01-26,China PR,2,England,0,2,0,China PR,England,1970,1928,42,-42
584,2007-01-26,USA,0,Germany,0,0,0,USA,Germany,2185,2229,-44,44
585,2007-01-28,China PR,0,Germany,0,0,0,China PR,Germany,1970,2229,-259,259
586,2007-01-28,USA,1,England,1,1,1,USA,England,2185,1928,257,-257
587,2007-01-30,China PR,0,USA,2,2,0,USA,China PR,2185,1970,215,-215
588,2007-01-30,England,0,Germany,0,0,0,England,Germany,1928,2229,-301,301
589,2007-03-07,France,0,Denmark,4,4,0,Denmark,France,1975,1991,-16,16
590,2007-03-07,Germany,1,Norway,2,2,1,Norway,Germany,2075,2229,-154,154
591,2007-03-07,Sweden,3,Finland,0,3,0,Sweden,Finland,2037,1871,166,-166
592,2007-03-07,USA,2,China PR,1,2,1,USA,China PR,2185,1970,215,-215
593,2007-03-07,Portugal,1,Republic of Ireland,1,1,1,Portugal,Republic of Ireland,1520,1617,-97,97
594,2007-03-07,Italy,2,Iceland,1,2,1,Italy,Iceland,1922,1789,133,-133
595,2007-03-09,France,1,Germany,0,1,0,France,Germany,1991,2229,-238,238
596,2007-03-09,Norway,0,Denmark,1,1,0,Denmark,Norway,1975,2075,-100,100
597,2007-03-09,Sweden,1,China PR,0,1,0,Sweden,China PR,2037,1970,67,-67
598,2007-03-09,USA,1,Finland,0,1,0,USA,Finland,2185,1871,314,-314
599,2007-03-09,Portugal,0,Italy,1,1,0,Italy,Portugal,1922,1520,402,-402
600,2007-03-09,Iceland,1,Republic of Ireland,1,1,1,Iceland,Republic of Ireland,1789,1617,172,-172
601,2007-03-12,France,1,Norway,0,1,0,France,Norway,1991,2075,-84,84
602,2007-03-12,Germany,3,Denmark,0,3,0,Germany,Denmark,2229,1975,254,-254
603,2007-03-12,Sweden,2,USA,3,3,2,USA,Sweden,2185,2037,148,-148
604,2007-03-12,China PR,0,Finland,2,2,0,Finland,China PR,1871,1970,-99,99
605,2007-03-12,Portugal,1,Iceland,5,5,1,Iceland,Portugal,1789,1520,269,-269
606,2007-03-12,Italy,4,Republic of Ireland,1,4,1,Italy,Republic of Ireland,1922,1617,305,-305
607,2007-03-14,Portugal,0,Republic of Ireland,0,0,0,Portugal,Republic of Ireland,1520,1617,-97,97
608,2007-03-14,Iceland,4,China PR,1,4,1,Iceland,China PR,1789,1970,-181,181
609,2007-03-14,Italy,1,Germany,0,1,0,Italy,Germany,1922,2229,-307,307
610,2007-03-14,Norway,2,Finland,0,2,0,Norway,Finland,2075,1871,204,-204
611,2007-03-14,Sweden,3,France,1,3,1,Sweden,France,2037,1991,46,-46
612,2007-03-14,USA,2,Denmark,0,2,0,USA,Denmark,2185,1975,210,-210
613,2007-04-01,Republic of Ireland,2,Hungary,1,2,1,Republic of Ireland,Hungary,1620,1601,19,-19
614,2007-04-09,New Zealand,6,Tonga,1,6,1,New Zealand,Tonga,1744,1461,283,-283
615,2007-04-09,Papua New Guinea,6,Solomon Islands,1,6,1,Papua New Guinea,Solomon Islands,1429,0,1429,-1429
616,2007-04-11,France,6,Greece,0,6,0,France,Greece,2002,1457,545,-545
617,2007-04-11,New Zealand,8,Solomon Islands,0,8,0,New Zealand,Solomon Islands,1744,0,1744,-1744
618,2007-04-11,Papua New Guinea,1,Tonga,0,1,0,Papua New Guinea,Tonga,1429,1461,-32,32
619,2007-04-12,Germany,5,Netherlands,1,5,1,Germany,Netherlands,2179,1830,349,-349
620,2007-04-13,Papua New Guinea,0,New Zealand,7,7,0,New Zealand,Papua New Guinea,1744,1429,315,-315
621,2007-04-13,Tonga,0,Solomon Islands,0,0,0,Tonga,Solomon Islands,1461,0,1461,-1461
622,2007-04-14,Slovakia,2,Portugal,1,2,1,Slovakia,Portugal,1606,1520,86,-86
623,2007-05-05,Italy,0,Sweden,2,2,0,Sweden,Italy,2046,1918,128,-128
624,2007-05-05,Hungary,3,Romania,3,3,3,Hungary,Romania,1601,1592,9,-9
625,2007-05-05,Slovenia,0,Serbia,5,5,0,Serbia,Slovenia,1650,1378,272,-272
626,2007-05-05,Switzerland,1,Belgium,0,1,0,Switzerland,Belgium,1649,1611,38,-38
627,2007-05-05,Austria,0,Poland,1,1,0,Poland,Austria,1668,1555,113,-113
628,2007-05-06,Scotland,0,Portugal,0,0,0,Scotland,Portugal,1692,1520,172,-172
629,2007-05-09,Switzerland,2,Netherlands,2,2,2,Switzerland,Netherlands,1649,1830,-181,181
630,2007-05-09,Slovakia,0,Ukraine,4,4,0,Ukraine,Slovakia,1834,1606,228,-228
631,2007-05-10,Wales,0,Germany,6,6,0,Germany,Wales,2179,1470,709,-709
632,2007-05-10,Israel,2,Poland,2,2,2,Israel,Poland,1383,1668,-285,285
633,2007-05-13,England,4,Northern Ireland,0,4,0,England,Northern Ireland,1938,1320,618,-618
634,2007-05-26,Northern Ireland,1,Czech Republic,3,3,1,Czech Republic,Northern Ireland,1803,1320,483,-483
635,2007-05-30,Belarus,0,Spain,3,3,0,Spain,Belarus,1793,1595,198,-198
636,2007-05-30,Republic of Ireland,1,Italy,2,2,1,Italy,Republic of Ireland,1918,1620,298,-298
637,2007-05-30,France,6,Slovenia,0,6,0,France,Slovenia,2002,1378,624,-624
638,2007-05-30,Ukraine,2,Scotland,1,2,1,Ukraine,Scotland,1834,1692,142,-142
639,2007-05-30,Israel,0,Russia,6,6,0,Russia,Israel,1895,1383,512,-512
640,2007-05-31,Greece,0,Iceland,3,3,0,Iceland,Greece,1783,1457,326,-326
641,2007-06-16,Romania,0,Sweden,7,7,0,Sweden,Romania,2071,1597,474,-474
642,2007-06-16,Iceland,1,France,0,1,0,Iceland,France,1794,2008,-214,214
643,2007-06-16,Russia,3,Poland,1,3,1,Russia,Poland,1897,1683,214,-214
644,2007-06-17,Israel,0,Norway,3,3,0,Norway,Israel,2055,1389,666,-666
645,2007-06-20,Sweden,7,Hungary,0,7,0,Sweden,Hungary,2071,1602,469,-469
646,2007-06-20,Ukraine,5,Slovakia,0,5,0,Ukraine,Slovakia,1843,1590,253,-253
647,2007-06-21,Iceland,5,Serbia,0,5,0,Iceland,Serbia,1794,1658,136,-136
648,2007-06-21,Poland,4,Israel,1,4,1,Poland,Israel,1683,1389,294,-294
649,2007-06-21,Norway,3,Austria,0,3,0,Norway,Austria,2055,1546,509,-509
650,2007-08-01,Belarus,5,Northern Ireland,0,5,0,Belarus,Northern Ireland,1573,1320,253,-253
651,2007-08-22,Germany,7,Switzerland,0,7,0,Germany,Switzerland,2148,1656,492,-492
652,2007-08-23,Austria,1,Russia,5,5,1,Russia,Austria,1897,1546,351,-351
653,2007-08-25,Romania,0,Republic of Ireland,2,2,0,Republic of Ireland,Romania,1623,1597,26,-26
654,2007-08-25,Serbia,1,Greece,2,2,1,Greece,Serbia,1452,1658,-206,206
655,2007-08-26,Belarus,1,Czech Republic,4,4,1,Czech Republic,Belarus,1804,1573,231,-231
656,2007-08-26,Slovenia,2,Iceland,1,2,1,Slovenia,Iceland,1370,1794,-424,424
657,2007-08-26,Netherlands,2,Wales,1,2,1,Netherlands,Wales,1834,1470,364,-364
658,2007-08-26,Austria,5,Israel,0,5,0,Austria,Israel,1546,1389,157,-157
659,2007-09-10,Germany,11,Argentina,0,11,0,Germany,Argentina,2148,1659,489,-489
660,2007-09-11,Japan,2,England,2,2,2,Japan,England,1944,1931,13,-13
661,2007-09-11,USA,2,Korea DPR,2,2,2,USA,Korea DPR,2204,2052,152,-152
662,2007-09-11,Nigeria,1,Sweden,1,1,1,Nigeria,Sweden,1705,2071,-366,366
663,2007-09-12,Ghana,1,Australia,4,4,1,Australia,Ghana,1893,1511,382,-382
664,2007-09-12,Norway,2,Canada,1,2,1,Norway,Canada,2055,1962,93,-93
665,2007-09-12,New Zealand,0,Brazil,5,5,0,Brazil,New Zealand,2000,1744,256,-256
666,2007-09-12,China PR,3,Denmark,2,3,2,China PR,Denmark,1934,2019,-85,85
667,2007-09-14,Argentina,0,Japan,1,1,0,Japan,Argentina,1944,1659,285,-285
668,2007-09-14,England,0,Germany,0,0,0,England,Germany,1931,2148,-217,217
669,2007-09-14,Sweden,0,USA,2,2,0,USA,Sweden,2204,2071,133,-133
670,2007-09-14,Korea DPR,2,Nigeria,0,2,0,Korea DPR,Nigeria,2052,1705,347,-347
671,2007-09-15,Canada,4,Ghana,0,4,0,Canada,Ghana,1962,1511,451,-451
672,2007-09-15,Australia,1,Norway,1,1,1,Australia,Norway,1893,2055,-162,162
673,2007-09-15,Denmark,2,New Zealand,0,2,0,Denmark,New Zealand,2019,1744,275,-275
674,2007-09-15,China PR,0,Brazil,4,4,0,Brazil,China PR,2000,1934,66,-66
675,2007-09-17,Germany,2,Japan,0,2,0,Germany,Japan,2148,1944,204,-204
676,2007-09-17,England,6,Argentina,1,6,1,England,Argentina,1931,1659,272,-272
677,2007-09-18,Nigeria,0,USA,1,1,0,USA,Nigeria,2204,1705,499,-499
678,2007-09-18,Korea DPR,1,Sweden,2,2,1,Sweden,Korea DPR,2071,2052,19,-19
679,2007-09-20,Norway,7,Ghana,2,7,2,Norway,Ghana,2055,1511,544,-544
680,2007-09-20,Australia,2,Canada,2,2,2,Australia,Canada,1893,1962,-69,69
681,2007-09-20,China PR,2,New Zealand,0,2,0,China PR,New Zealand,1934,1744,190,-190
682,2007-09-20,Brazil,1,Denmark,0,1,0,Brazil,Denmark,2000,2019,-19,19
683,2007-09-22,Germany,3,Korea DPR,0,3,0,Germany,Korea DPR,2148,2052,96,-96
684,2007-09-22,USA,3,England,0,3,0,USA,England,2204,1931,273,-273
685,2007-09-23,China PR,0,Norway,1,1,0,Norway,China PR,2055,1934,121,-121
686,2007-09-23,Brazil,3,Australia,2,3,2,Brazil,Australia,2000,1893,107,-107
687,2007-09-26,Germany,3,Norway,0,3,0,Germany,Norway,2148,2055,93,-93
688,2007-09-27,USA,0,Brazil,4,4,0,Brazil,USA,2000,2204,-204,204
689,2007-09-30,Norway,1,USA,4,4,1,USA,Norway,2204,2055,149,-149
690,2007-09-30,Germany,2,Brazil,0,2,0,Germany,Brazil,2148,2000,148,-148
691,2007-10-20,India,3,IR Iran,1,3,1,India,IR Iran,1439,0,1439,-1439
692,2007-10-20,Hong Kong,2,Philippines,3,3,2,Philippines,Hong Kong,1262,1383,-121,121
693,2007-10-20,Singapore,0,Malaysia,2,2,0,Malaysia,Singapore,1299,1211,88,-88
694,2007-10-22,Hong Kong,1,Philippines,1,1,1,Hong Kong,Philippines,1383,1262,121,-121
695,2007-10-27,England,4,Belarus,0,4,0,England,Belarus,1944,1568,376,-376
696,2007-10-27,Czech Republic,2,Spain,2,2,2,Czech Republic,Spain,1812,1802,10,-10
697,2007-10-27,Hungary,1,Italy,3,3,1,Italy,Hungary,1910,1600,310,-310
698,2007-10-27,Republic of Ireland,2,Romania,1,2,1,Republic of Ireland,Romania,1639,1584,55,-55
699,2007-10-27,Serbia,0,France,8,8,0,France,Serbia,1993,1632,361,-361
700,2007-10-27,Slovakia,0,Scotland,3,3,0,Scotland,Slovakia,1687,1587,100,-100
701,2007-10-27,Denmark,5,Portugal,1,5,1,Denmark,Portugal,1973,1522,451,-451
702,2007-10-27,Norway,3,Russia,0,3,0,Norway,Russia,2035,1903,132,-132
703,2007-10-27,IR Iran,4,India,1,4,1,IR Iran,India,0,1439,-1439,1439
704,2007-10-27,Malaysia,0,Singapore,1,1,0,Singapore,Malaysia,1211,1299,-88,88
705,2007-10-28,Wales,0,Switzerland,2,2,0,Switzerland,Wales,1650,1473,177,-177
706,2007-10-28,Germany,3,Belgium,0,3,0,Germany,Belgium,2201,1605,596,-596
707,2007-10-31,Italy,5,Romania,0,5,0,Italy,Romania,1910,1584,326,-326
708,2007-10-31,Slovenia,0,France,2,2,0,France,Slovenia,1993,1392,601,-601
709,2007-10-31,Belgium,1,Wales,0,1,0,Belgium,Wales,1605,1473,132,-132
710,2007-10-31,Scotland,0,Denmark,1,1,0,Denmark,Scotland,1973,1687,286,-286
711,2007-11-01,Netherlands,0,Germany,1,1,0,Germany,Netherlands,2201,1833,368,-368
712,2007-11-25,England,1,Spain,0,1,0,England,Spain,1944,1802,142,-142
713,2008-01-16,China PR,2,Finland,0,2,0,China PR,Finland,1918,1877,41,-41
714,2008-01-16,USA,4,Canada,0,4,0,USA,Canada,2186,1950,236,-236
715,2008-01-18,China PR,0,Canada,0,0,0,China PR,Canada,1918,1950,-32,32
716,2008-01-18,USA,4,Finland,1,4,1,USA,Finland,2186,1877,309,-309
717,2008-01-20,Canada,1,Finland,1,1,1,Canada,Finland,1950,1877,73,-73
718,2008-01-20,China PR,0,USA,1,1,0,USA,China PR,2186,1918,268,-268
719,2008-02-16,Spain,4,Northern Ireland,0,4,0,Spain,Northern Ireland,1805,1317,488,-488
720,2008-02-16,Italy,4,Republic of Ireland,1,4,1,Italy,Republic of Ireland,1916,1643,273,-273
721,2008-02-16,Portugal,0,Slovakia,1,1,0,Slovakia,Portugal,1573,1522,51,-51
722,2008-02-17,Wales,0,Belgium,1,1,0,Belgium,Wales,1607,1462,145,-145
723,2008-02-20,Wales,0,Netherlands,1,1,0,Netherlands,Wales,1827,1462,365,-365
724,2008-02-21,Portugal,0,Ukraine,1,1,0,Ukraine,Portugal,1846,1522,324,-324
725,2008-03-05,Germany,0,Denmark,1,1,0,Denmark,Germany,1960,2201,-241,241
726,2008-03-05,Finland,1,Sweden,3,3,1,Sweden,Finland,2086,1877,209,-209
727,2008-03-05,China PR,0,USA,4,4,0,USA,China PR,2186,1918,268,-268
728,2008-03-05,Norway,4,Italy,2,4,2,Norway,Italy,2040,1916,124,-124
729,2008-03-05,Iceland,2,Poland,0,2,0,Iceland,Poland,1793,1680,113,-113
730,2008-03-05,Portugal,2,Republic of Ireland,0,2,0,Portugal,Republic of Ireland,1522,1643,-121,121
731,2008-03-05,USA,2,Scotland,1,2,1,USA,Scotland,2186,1697,489,-489
732,2008-03-05,Canada,2,Russia,1,2,1,Canada,Russia,1950,1898,52,-52
733,2008-03-05,Japan,3,Netherlands,1,3,1,Japan,Netherlands,1943,1827,116,-116
734,2008-03-06,Northern Ireland,0,England,2,2,0,England,Northern Ireland,1946,1317,629,-629
735,2008-03-07,Germany,3,Finland,0,3,0,Germany,Finland,2201,1877,324,-324
736,2008-03-07,Denmark,1,Sweden,0,1,0,Denmark,Sweden,1960,2086,-126,126
737,2008-03-07,USA,2,Italy,0,2,0,USA,Italy,2186,1916,270,-270
738,2008-03-07,Norway,3,China PR,1,3,1,Norway,China PR,2040,1918,122,-122
739,2008-03-07,Portugal,3,Poland,1,3,1,Portugal,Poland,1522,1680,-158,158
740,2008-03-07,Republic of Ireland,1,Iceland,4,4,1,Iceland,Republic of Ireland,1793,1643,150,-150
741,2008-03-07,Scotland,0,Netherlands,1,1,0,Netherlands,Scotland,1827,1697,130,-130
742,2008-03-07,Japan,0,Canada,3,3,0,Canada,Japan,1950,1943,7,-7
743,2008-03-07,Russia,2,USA,0,2,0,Russia,USA,1898,2186,-288,288
744,2008-03-10,Denmark,1,Finland,0,1,0,Denmark,Finland,1960,1877,83,-83
745,2008-03-10,Sweden,0,Germany,2,2,0,Germany,Sweden,2201,2086,115,-115
746,2008-03-10,China PR,0,Italy,2,2,0,Italy,China PR,1916,1918,-2,2
747,2008-03-10,USA,4,Norway,0,4,0,USA,Norway,2186,2040,146,-146
748,2008-03-10,Portugal,0,Iceland,3,3,0,Iceland,Portugal,1793,1522,271,-271
749,2008-03-10,Poland,0,Republic of Ireland,1,1,0,Republic of Ireland,Poland,1643,1680,-37,37
750,2008-03-10,Netherlands,0,USA,2,2,0,USA,Netherlands,2186,1827,359,-359
751,2008-03-10,Russia,1,Japan,3,3,1,Japan,Russia,1943,1898,45,-45
752,2008-03-10,Scotland,2,Canada,0,2,0,Scotland,Canada,1697,1950,-253,253
753,2008-03-12,Republic of Ireland,2,Poland,2,2,2,Republic of Ireland,Poland,1643,1680,-37,37
754,2008-03-12,Portugal,1,China PR,1,1,1,Portugal,China PR,1522,1918,-396,396
755,2008-03-12,Finland,0,Iceland,3,3,0,Iceland,Finland,1793,1877,-84,84
756,2008-03-12,Sweden,3,Italy,0,3,0,Sweden,Italy,2086,1916,170,-170
757,2008-03-12,Germany,0,Norway,2,2,0,Norway,Germany,2040,2201,-161,161
758,2008-03-12,Denmark,1,USA,2,2,1,USA,Denmark,2186,1960,226,-226
759,2008-03-12,Russia,3,Scotland,2,3,2,Russia,Scotland,1898,1697,201,-201
760,2008-03-12,Netherlands,1,Japan,2,2,1,Japan,Netherlands,1943,1827,116,-116
761,2008-03-12,Canada,3,USA,2,3,2,Canada,USA,1950,2186,-236,236
762,2008-03-20,England,0,Czech Republic,0,0,0,England,Czech Republic,1946,1808,138,-138
763,2008-03-24,Myanmar,0,Chinese Taipei,3,3,0,Chinese Taipei,Myanmar,1651,1544,107,-107
764,2008-03-24,Vietnam,4,IR Iran,1,4,1,Vietnam,IR Iran,1581,1454,127,-127
765,2008-03-24,Thailand,11,Malaysia,0,11,0,Thailand,Malaysia,1611,1290,321,-321
766,2008-03-24,Korea Republic,4,Philippines,0,4,0,Korea Republic,Philippines,1707,1278,429,-429
767,2008-03-26,Vietnam,3,Chinese Taipei,1,3,1,Vietnam,Chinese Taipei,1581,1651,-70,70
768,2008-03-26,IR Iran,1,Myanmar,2,2,1,Myanmar,IR Iran,1544,1454,90,-90
769,2008-03-26,Malaysia,0,Korea Republic,13,13,0,Korea Republic,Malaysia,1707,1290,417,-417
770,2008-03-26,Thailand,9,Philippines,0,9,0,Thailand,Philippines,1611,1278,333,-333
771,2008-03-28,Vietnam,1,Myanmar,0,1,0,Vietnam,Myanmar,1581,1544,37,-37
772,2008-03-28,Chinese Taipei,2,IR Iran,3,3,2,IR Iran,Chinese Taipei,1454,1651,-197,197
773,2008-03-28,Thailand,0,Korea Republic,4,4,0,Korea Republic,Thailand,1707,1611,96,-96
774,2008-03-28,Malaysia,0,Philippines,0,0,0,Malaysia,Philippines,1290,1278,12,-12
775,2008-04-23,Hungary,0,Republic of Ireland,2,2,0,Republic of Ireland,Hungary,1642,1591,51,-51
776,2008-04-23,Greece,0,France,5,5,0,France,Greece,1998,1473,525,-525
777,2008-04-23,Belgium,2,Netherlands,2,2,2,Belgium,Netherlands,1616,1823,-207,207
778,2008-04-23,Slovakia,1,Denmark,4,4,1,Denmark,Slovakia,1996,1585,411,-411
779,2008-04-26,Czech Republic,4,Northern Ireland,0,4,0,Czech Republic,Northern Ireland,1808,1318,490,-490
780,2008-04-27,Belgium,3,Switzerland,1,3,1,Belgium,Switzerland,1616,1659,-43,43
781,2008-04-27,Denmark,2,Scotland,1,2,1,Denmark,Scotland,1996,1704,292,-292
782,2008-05-03,Spain,6,Belarus,1,6,1,Spain,Belarus,1805,1567,238,-238
783,2008-05-03,Hungary,0,Sweden,6,6,0,Sweden,Hungary,2084,1591,493,-493
784,2008-05-03,Serbia,0,Slovenia,3,3,0,Slovenia,Serbia,1398,1627,-229,229
785,2008-05-03,Portugal,1,Scotland,4,4,1,Scotland,Portugal,1704,1521,183,-183
786,2008-05-03,Norway,7,Israel,0,7,0,Norway,Israel,2042,1383,659,-659
787,2008-05-07,Sweden,1,Italy,0,1,0,Sweden,Italy,2084,1914,170,-170
788,2008-05-07,Belgium,0,Germany,5,5,0,Germany,Belgium,2173,1616,557,-557
789,2008-05-07,Norway,3,Poland,0,3,0,Norway,Poland,2042,1659,383,-383
790,2008-05-08,Belarus,1,England,6,6,1,England,Belarus,1945,1567,378,-378
791,2008-05-08,Spain,4,Czech Republic,1,4,1,Spain,Czech Republic,1805,1808,-3,3
792,2008-05-08,France,2,Serbia,0,2,0,France,Serbia,1998,1627,371,-371
793,2008-05-08,Switzerland,2,Wales,0,2,0,Switzerland,Wales,1659,1456,203,-203
794,2008-05-08,Portugal,0,Denmark,4,4,0,Denmark,Portugal,1996,1521,475,-475
795,2008-05-24,Romania,1,Italy,6,6,1,Italy,Romania,1914,1578,336,-336
796,2008-05-28,Northern Ireland,0,Spain,3,3,0,Spain,Northern Ireland,1805,1318,487,-487
797,2008-05-28,Romania,3,Hungary,1,3,1,Romania,Hungary,1578,1591,-13,13
798,2008-05-28,Serbia,0,Iceland,4,4,0,Iceland,Serbia,1812,1627,185,-185
799,2008-05-28,Slovenia,3,Greece,1,3,1,Slovenia,Greece,1398,1473,-75,75
800,2008-05-28,Denmark,6,Slovakia,1,6,1,Denmark,Slovakia,1996,1585,411,-411
801,2008-05-28,Scotland,0,Ukraine,1,1,0,Ukraine,Scotland,1848,1704,144,-144
802,2008-05-28,Poland,2,Austria,4,4,2,Austria,Poland,1547,1659,-112,112
803,2008-05-28,Korea DPR,5,Thailand,0,5,0,Korea DPR,Thailand,2023,1611,412,-412
804,2008-05-28,Vietnam,0,China PR,1,1,0,China PR,Vietnam,1893,1581,312,-312
805,2008-05-29,Germany,4,Wales,0,4,0,Germany,Wales,2173,1456,717,-717
806,2008-05-29,Russia,4,Israel,0,4,0,Russia,Israel,1890,1383,507,-507
807,2008-05-29,Australia,4,Chinese Taipei,0,4,0,Australia,Chinese Taipei,1929,1651,278,-278
808,2008-05-29,Japan,1,Korea Republic,3,3,1,Korea Republic,Japan,1707,1956,-249,249
809,2008-05-30,Vietnam,0,Korea DPR,3,3,0,Korea DPR,Vietnam,2023,1581,442,-442
810,2008-05-30,Thailand,1,China PR,5,5,1,China PR,Thailand,1893,1611,282,-282
811,2008-05-31,Chinese Taipei,0,Japan,11,11,0,Japan,Chinese Taipei,1956,1651,305,-305
812,2008-05-31,Korea Republic,0,Australia,2,2,0,Australia,Korea Republic,1929,1707,222,-222
813,2008-06-01,China PR,0,Korea DPR,1,1,0,Korea DPR,China PR,2023,1893,130,-130
814,2008-06-01,Vietnam,1,Thailand,0,1,0,Vietnam,Thailand,1581,1611,-30,30
815,2008-06-02,Australia,1,Japan,3,3,1,Japan,Australia,1956,1929,27,-27
816,2008-06-02,Korea Republic,2,Chinese Taipei,0,2,0,Korea Republic,Chinese Taipei,1707,1651,56,-56
817,2008-06-05,Korea DPR,3,Australia,0,3,0,Korea DPR,Australia,2023,1929,94,-94
818,2008-06-05,Japan,1,China PR,3,3,1,China PR,Japan,1893,1956,-63,63
819,2008-06-08,Australia,0,Japan,3,3,0,Japan,Australia,1957,1923,34,-34
820,2008-06-08,Korea DPR,2,China PR,1,2,1,Korea DPR,China PR,2038,1891,147,-147
821,2008-06-21,Iceland,5,Slovenia,0,5,0,Iceland,Slovenia,1827,1438,389,-389
822,2008-06-21,Austria,0,Norway,4,4,0,Norway,Austria,2043,1567,476,-476
823,2008-06-22,Ukraine,1,Denmark,0,1,0,Ukraine,Denmark,1857,2000,-143,143
824,2008-06-25,Republic of Ireland,0,Sweden,5,5,0,Sweden,Republic of Ireland,2087,1657,430,-430
825,2008-06-25,Israel,0,Austria,2,2,0,Austria,Israel,1567,1383,184,-184
826,2008-06-25,Poland,0,Norway,3,3,0,Norway,Poland,2043,1638,405,-405
827,2008-06-26,Czech Republic,3,Belarus,1,3,1,Czech Republic,Belarus,1806,1560,246,-246
828,2008-06-26,Iceland,7,Greece,0,7,0,Iceland,Greece,1827,1461,366,-366
829,2008-07-25,Northern Ireland,1,Belarus,1,1,1,Northern Ireland,Belarus,1316,1560,-244,244
830,2008-08-06,Argentina,1,Canada,2,2,1,Canada,Argentina,1960,1658,302,-302
831,2008-08-06,China PR,2,Sweden,1,2,1,China PR,Sweden,1891,2087,-196,196
832,2008-08-06,Germany,0,Brazil,0,0,0,Germany,Brazil,2174,2082,92,-92
833,2008-08-06,Korea DPR,1,Nigeria,0,1,0,Korea DPR,Nigeria,2038,1718,320,-320
834,2008-08-06,Japan,2,New Zealand,2,2,2,Japan,New Zealand,1957,1724,233,-233
835,2008-08-06,Norway,2,USA,0,2,0,Norway,USA,2043,2200,-157,157
836,2008-08-09,Sweden,1,Argentina,0,1,0,Sweden,Argentina,2087,1658,429,-429
837,2008-08-09,China PR,1,Canada,1,1,1,China PR,Canada,1891,1960,-69,69
838,2008-08-09,Nigeria,0,Germany,1,1,0,Germany,Nigeria,2174,1718,456,-456
839,2008-08-09,Brazil,2,Korea DPR,1,2,1,Brazil,Korea DPR,2082,2038,44,-44
840,2008-08-09,USA,1,Japan,0,1,0,USA,Japan,2200,1957,243,-243
841,2008-08-09,New Zealand,0,Norway,1,1,0,Norway,New Zealand,2043,1724,319,-319
842,2008-08-12,China PR,2,Argentina,0,2,0,China PR,Argentina,1891,1658,233,-233
843,2008-08-12,Sweden,2,Canada,1,2,1,Sweden,Canada,2087,1960,127,-127
844,2008-08-12,Korea DPR,0,Germany,1,1,0,Germany,Korea DPR,2174,2038,136,-136
845,2008-08-12,Nigeria,1,Brazil,3,3,1,Brazil,Nigeria,2082,1718,364,-364
846,2008-08-12,Norway,1,Japan,5,5,1,Japan,Norway,1957,2043,-86,86
847,2008-08-12,USA,4,New Zealand,0,4,0,USA,New Zealand,2200,1724,476,-476
848,2008-08-15,USA,2,Canada,1,2,1,USA,Canada,2200,1960,240,-240
849,2008-08-15,Brazil,2,Norway,1,2,1,Brazil,Norway,2082,2043,39,-39
850,2008-08-15,Sweden,0,Germany,2,2,0,Germany,Sweden,2174,2087,87,-87
851,2008-08-15,China PR,0,Japan,2,2,0,Japan,China PR,1957,1891,66,-66
852,2008-08-18,Brazil,4,Germany,1,4,1,Brazil,Germany,2082,2174,-92,92
853,2008-08-18,USA,4,Japan,2,4,2,USA,Japan,2200,1957,243,-243
854,2008-08-21,Germany,2,Japan,0,2,0,Germany,Japan,2174,1957,217,-217
855,2008-08-21,Brazil,0,USA,1,1,0,USA,Brazil,2200,2082,118,-118
856,2008-08-27,Russia,3,Austria,1,3,1,Russia,Austria,1890,1567,323,-323
857,2008-08-30,Netherlands,1,Switzerland,1,1,1,Netherlands,Switzerland,1818,1657,161,-161
858,2008-09-27,Sweden,2,Romania,0,2,0,Sweden,Romania,2063,1578,485,-485
859,2008-09-27,Greece,0,Serbia,5,5,0,Serbia,Greece,1594,1459,135,-135
860,2008-09-27,France,2,Iceland,1,2,1,France,Iceland,1999,1830,169,-169
861,2008-09-27,Netherlands,3,Belgium,0,3,0,Netherlands,Belgium,1808,1624,184,-184
862,2008-09-27,Ukraine,1,Portugal,1,1,1,Ukraine,Portugal,1869,1509,360,-360
863,2008-09-27,Poland,1,Russia,4,4,1,Russia,Poland,1890,1629,261,-261
864,2008-09-28,Czech Republic,1,England,5,5,1,England,Czech Republic,1939,1807,132,-132
865,2008-09-28,Scotland,6,Slovakia,0,6,0,Scotland,Slovakia,1714,1577,137,-137
866,2008-10-01,Sweden,1,Republic of Ireland,0,1,0,Sweden,Republic of Ireland,2063,1654,409,-409
867,2008-10-01,Switzerland,0,Germany,3,3,0,Germany,Switzerland,2152,1667,485,-485
868,2008-10-01,Denmark,1,Ukraine,0,1,0,Denmark,Ukraine,1988,1869,119,-119
869,2008-10-02,Spain,2,England,2,2,2,Spain,England,1819,1939,-120,120
870,2008-10-02,Italy,3,Hungary,0,3,0,Italy,Hungary,1905,1566,339,-339
871,2008-10-02,Greece,4,Slovenia,6,6,4,Slovenia,Greece,1437,1459,-22,22
872,2008-10-02,Russia,0,Norway,0,0,0,Russia,Norway,1890,2021,-131,131
873,2008-10-25,Czech Republic,0,Italy,1,1,0,Italy,Czech Republic,1905,1807,98,-98
874,2008-10-25,Spain,0,Netherlands,2,2,0,Netherlands,Spain,1808,1819,-11,11
875,2008-10-26,Republic of Ireland,1,Iceland,1,1,1,Republic of Ireland,Iceland,1654,1830,-176,176
876,2008-10-26,Scotland,2,Russia,3,3,2,Russia,Scotland,1890,1714,176,-176
877,2008-10-26,Slovenia,0,Ukraine,3,3,0,Ukraine,Slovenia,1869,1437,432,-432
878,2008-10-29,Italy,2,Czech Republic,1,2,1,Italy,Czech Republic,1905,1807,98,-98
879,2008-10-30,Iceland,3,Republic of Ireland,0,3,0,Iceland,Republic of Ireland,1830,1654,176,-176
880,2008-10-30,Russia,1,Scotland,2,2,1,Scotland,Russia,1714,1890,-176,176
881,2008-10-30,Netherlands,2,Spain,0,2,0,Netherlands,Spain,1808,1819,-11,11
882,2008-10-30,Ukraine,2,Slovenia,0,2,0,Ukraine,Slovenia,1869,1437,432,-432
883,2008-11-15,Equatorial Guinea,1,Cameroon,0,1,0,Equatorial Guinea,Cameroon,1258,1281,-23,23
884,2008-11-15,Mali,0,Congo,1,1,0,Congo,Mali,1192,1310,-118,118
885,2008-11-16,Nigeria,1,Ghana,1,1,1,Nigeria,Ghana,1728,1535,193,-193
886,2008-11-16,South Africa,2,Tunisia,1,2,1,South Africa,Tunisia,1355,1317,38,-38
887,2008-11-18,Cameroon,2,Mali,1,2,1,Cameroon,Mali,1281,1310,-29,29
888,2008-11-18,Equatorial Guinea,5,Congo,2,5,2,Equatorial Guinea,Congo,1258,1192,66,-66
889,2008-11-19,Ghana,0,South Africa,1,1,0,South Africa,Ghana,1355,1535,-180,180
890,2008-11-19,Tunisia,0,Nigeria,0,0,0,Tunisia,Nigeria,1317,1728,-411,411
891,2008-11-21,Equatorial Guinea,2,Mali,1,2,1,Equatorial Guinea,Mali,1258,1310,-52,52
892,2008-11-21,Cameroon,1,Congo,0,1,0,Cameroon,Congo,1281,1192,89,-89
893,2008-11-22,Nigeria,1,South Africa,0,1,0,Nigeria,South Africa,1728,1355,373,-373
894,2008-11-22,Ghana,3,Tunisia,2,3,2,Ghana,Tunisia,1535,1317,218,-218
895,2008-11-25,Equatorial Guinea,1,Nigeria,0,1,0,Equatorial Guinea,Nigeria,1258,1728,-470,470
896,2008-11-25,South Africa,3,Cameroon,0,3,0,South Africa,Cameroon,1355,1281,74,-74
897,2008-11-28,Nigeria,1,Cameroon,1,1,1,Nigeria,Cameroon,1728,1281,447,-447
898,2008-11-29,Equatorial Guinea,2,South Africa,1,2,1,Equatorial Guinea,South Africa,1258,1355,-97,97
899,2009-01-10,Korea Republic,4,Finland,0,4,0,Korea Republic,Finland,1774,1847,-73,73
900,2009-01-10,China PR,6,New Zealand,0,6,0,China PR,New Zealand,1916,1745,171,-171
901,2009-01-12,China PR,1,Finland,0,1,0,China PR,Finland,1916,1847,69,-69
902,2009-01-12,Korea Republic,4,New Zealand,3,4,3,Korea Republic,New Zealand,1774,1745,29,-29
903,2009-01-14,China PR,1,Korea Republic,0,1,0,China PR,Korea Republic,1916,1774,142,-142
904,2009-01-14,New Zealand,0,Finland,2,2,0,Finland,New Zealand,1847,1745,102,-102
905,2009-03-04,Germany,2,Finland,0,2,0,Germany,Finland,2154,1847,307,-307
906,2009-03-04,China PR,0,Sweden,0,0,0,China PR,Sweden,1916,2059,-143,143
907,2009-03-04,USA,2,Denmark,0,2,0,USA,Denmark,2197,1990,207,-207
908,2009-03-04,Norway,1,Iceland,3,3,1,Iceland,Norway,1831,2019,-188,188
909,2009-03-04,Wales,1,Austria,2,2,1,Austria,Wales,1574,1464,110,-110
910,2009-03-04,Portugal,2,Poland,1,2,1,Portugal,Poland,1522,1622,-100,100
911,2009-03-05,South Africa,0,England,6,6,0,England,South Africa,1950,1395,555,-555
912,2009-03-05,France,2,Scotland,0,2,0,France,Scotland,1988,1737,251,-251
913,2009-03-05,Netherlands,2,Russia,1,2,1,Netherlands,Russia,1847,1884,-37,37
914,2009-03-05,Canada,1,New Zealand,1,1,1,Canada,New Zealand,1944,1745,199,-199
915,2009-03-06,Sweden,1,Finland,0,1,0,Sweden,Finland,2059,1847,212,-212
916,2009-03-06,Germany,3,China PR,0,3,0,Germany,China PR,2154,1916,238,-238
917,2009-03-06,USA,1,Iceland,0,1,0,USA,Iceland,2197,1831,366,-366
918,2009-03-06,Denmark,2,Norway,0,2,0,Denmark,Norway,1990,2019,-29,29
919,2009-03-06,Austria,1,Poland,1,1,1,Austria,Poland,1574,1622,-48,48
920,2009-03-06,Portugal,2,Wales,1,2,1,Portugal,Wales,1522,1464,58,-58
921,2009-03-07,England,2,France,2,2,2,England,France,1950,1988,-38,38
922,2009-03-07,South Africa,2,Scotland,0,2,0,South Africa,Scotland,1395,1737,-342,342
923,2009-03-07,Canada,2,Netherlands,1,2,1,Canada,Netherlands,1944,1847,97,-97
924,2009-03-07,Russia,4,New Zealand,2,4,2,Russia,New Zealand,1884,1745,139,-139
925,2009-03-09,Finland,0,China PR,1,1,0,China PR,Finland,1916,1847,69,-69
926,2009-03-09,Sweden,3,Germany,2,3,2,Sweden,Germany,2059,2154,-95,95
927,2009-03-09,Norway,0,USA,1,1,0,USA,Norway,2197,2019,178,-178
928,2009-03-09,Iceland,0,Denmark,2,2,0,Denmark,Iceland,1990,1831,159,-159
929,2009-03-09,Portugal,1,Austria,0,1,0,Portugal,Austria,1522,1574,-52,52
930,2009-03-09,Poland,1,Wales,5,5,1,Wales,Poland,1464,1622,-158,158
931,2009-03-10,England,3,Scotland,0,3,0,England,Scotland,1950,1737,213,-213
932,2009-03-10,France,3,South Africa,2,3,2,France,South Africa,1988,1395,593,-593
933,2009-03-10,Canada,2,Russia,0,2,0,Canada,Russia,1944,1884,60,-60
934,2009-03-10,New Zealand,2,Netherlands,0,2,0,New Zealand,Netherlands,1745,1847,-102,102
935,2009-03-11,Wales,1,Poland,2,2,1,Poland,Wales,1622,1464,158,-158
936,2009-03-11,Austria,0,Norway,2,2,0,Norway,Austria,2019,1574,445,-445
937,2009-03-11,Portugal,1,Finland,1,1,1,Portugal,Finland,1522,1847,-325,325
938,2009-03-11,China PR,2,Iceland,1,2,1,China PR,Iceland,1916,1831,85,-85
939,2009-03-11,Germany,0,Denmark,1,1,0,Denmark,Germany,1990,2154,-164,164
940,2009-03-11,USA,1,Sweden,1,1,1,USA,Sweden,2197,2059,138,-138
941,2009-03-12,Scotland,2,Russia,1,2,1,Scotland,Russia,1737,1884,-147,147
942,2009-03-12,Netherlands,5,South Africa,0,5,0,Netherlands,South Africa,1847,1395,452,-452
943,2009-03-12,France,1,New Zealand,1,1,1,France,New Zealand,1988,1745,243,-243
944,2009-03-12,England,3,Canada,1,3,1,England,Canada,1950,1944,6,-6
945,2009-04-25,Kyrgyz Republic,1,Jordan,7,7,1,Jordan,Kyrgyz Republic,1401,1233,168,-168
946,2009-04-25,Palestine,4,Maldives,0,4,0,Palestine,Maldives,1308,965,343,-343
947,2009-04-27,Maldives,0,Uzbekistan,5,5,0,Uzbekistan,Maldives,1501,965,536,-536
948,2009-04-27,Palestine,1,Kyrgyz Republic,4,4,1,Kyrgyz Republic,Palestine,1233,1308,-75,75
949,2009-04-29,Uzbekistan,5,Palestine,0,5,0,Uzbekistan,Palestine,1501,1308,193,-193
950,2009-04-29,Jordan,9,Maldives,0,9,0,Jordan,Maldives,1401,965,436,-436
951,2009-05-01,Jordan,5,Palestine,0,5,0,Jordan,Palestine,1401,1308,93,-93
952,2009-05-01,Kyrgyz Republic,0,Uzbekistan,2,2,0,Uzbekistan,Kyrgyz Republic,1501,1233,268,-268
953,2009-05-03,Maldives,0,Kyrgyz Republic,2,2,0,Kyrgyz Republic,Maldives,1233,965,268,-268
954,2009-05-03,Uzbekistan,2,Jordan,2,2,2,Uzbekistan,Jordan,1501,1401,100,-100
955,2009-07-04,Thailand,6,Uzbekistan,1,6,1,Thailand,Uzbekistan,1594,1502,92,-92
956,2009-07-04,Vietnam,10,Kyrgyz Republic,1,10,1,Vietnam,Kyrgyz Republic,1625,1233,392,-392
957,2009-07-06,IR Iran,1,Uzbekistan,4,4,1,Uzbekistan,IR Iran,1502,1468,34,-34
958,2009-07-06,Hong Kong,2,Kyrgyz Republic,0,2,0,Hong Kong,Kyrgyz Republic,1368,1233,135,-135
959,2009-07-08,Thailand,8,IR Iran,1,8,1,Thailand,IR Iran,1594,1468,126,-126
960,2009-07-08,Vietnam,7,Hong Kong,0,7,0,Vietnam,Hong Kong,1625,1368,257,-257
961,2009-07-10,Chinese Taipei,0,Jordan,1,1,0,Jordan,Chinese Taipei,1453,1611,-158,158
962,2009-07-12,Myanmar,3,Jordan,0,3,0,Myanmar,Jordan,1523,1453,70,-70
963,2009-07-14,Chinese Taipei,2,Myanmar,5,5,2,Myanmar,Chinese Taipei,1523,1611,-88,88
964,2009-08-23,Ukraine,0,Netherlands,2,2,0,Netherlands,Ukraine,1844,1860,-16,16
965,2009-08-23,Finland,1,Denmark,0,1,0,Finland,Denmark,1836,2018,-182,182
966,2009-08-24,Germany,4,Norway,0,4,0,Germany,Norway,2119,1972,147,-147
967,2009-08-24,Iceland,1,France,3,3,1,France,Iceland,1982,1833,149,-149
968,2009-08-25,Italy,2,England,1,2,1,Italy,England,1928,1973,-45,45
969,2009-08-25,Sweden,3,Russia,0,3,0,Sweden,Russia,2100,1864,236,-236
970,2009-08-26,Ukraine,1,Denmark,2,2,1,Denmark,Ukraine,2018,1860,158,-158
971,2009-08-26,Finland,2,Netherlands,1,2,1,Finland,Netherlands,1836,1844,-8,8
972,2009-08-27,France,1,Germany,5,5,1,Germany,France,2119,1982,137,-137
973,2009-08-27,Iceland,0,Norway,1,1,0,Norway,Iceland,1972,1833,139,-139
974,2009-08-28,Italy,0,Sweden,2,2,0,Sweden,Italy,2100,1928,172,-172
975,2009-08-28,England,3,Russia,2,3,2,England,Russia,1973,1864,109,-109
976,2009-08-29,Finland,0,Ukraine,1,1,0,Ukraine,Finland,1860,1836,24,-24
977,2009-08-29,Denmark,1,Netherlands,2,2,1,Netherlands,Denmark,1844,2018,-174,174
978,2009-08-30,Germany,1,Iceland,0,1,0,Germany,Iceland,2119,1833,286,-286
979,2009-08-30,Norway,1,France,1,1,1,Norway,France,1972,1982,-10,10
980,2009-08-31,Russia,0,Italy,2,2,0,Italy,Russia,1928,1864,64,-64
981,2009-08-31,Sweden,1,England,1,1,1,Sweden,England,2100,1973,127,-127
982,2009-09-03,Finland,2,England,3,3,2,England,Finland,1973,1836,137,-137
983,2009-09-03,Netherlands,0,France,0,0,0,Netherlands,France,1844,1982,-138,138
984,2009-09-04,Germany,2,Italy,1,2,1,Germany,Italy,2119,1928,191,-191
985,2009-09-04,Sweden,1,Norway,3,3,1,Norway,Sweden,1972,2100,-128,128
986,2009-09-06,England,2,Netherlands,1,2,1,England,Netherlands,1973,1844,129,-129
987,2009-09-07,Germany,3,Norway,1,3,1,Germany,Norway,2119,1972,147,-147
988,2009-09-10,England,2,Germany,6,6,2,Germany,England,2119,1973,146,-146
989,2010-02-24,China PR,1,Finland,1,1,1,China PR,Finland,1938,1846,92,-92
990,2010-02-24,Germany,4,Denmark,0,4,0,Germany,Denmark,2149,1955,194,-194
991,2010-02-24,USA,2,Iceland,0,2,0,USA,Iceland,2210,1822,388,-388
992,2010-02-24,Norway,2,Sweden,2,2,2,Norway,Sweden,2001,2067,-66,66
993,2010-02-24,Portugal,5,Faroe Islands,0,5,0,Portugal,Faroe Islands,1566,1362,204,-204
994,2010-02-24,Romania,2,Austria,0,2,0,Romania,Austria,1583,1572,11,-11
995,2010-02-24,Scotland,1,Netherlands,4,4,1,Netherlands,Scotland,1838,1726,112,-112
996,2010-02-24,New Zealand,1,Italy,0,1,0,New Zealand,Italy,1748,1947,-199,199
997,2010-02-24,England,1,South Africa,0,1,0,England,South Africa,1977,1409,568,-568
998,2010-02-24,Canada,2,Switzerland,1,2,1,Canada,Switzerland,1939,1660,279,-279
999,2010-02-26,Denmark,0,China PR,2,2,0,China PR,Denmark,1938,1955,-17,17
1000,2010-02-26,Germany,7,Finland,0,7,0,Germany,Finland,2149,1846,303,-303
1001,2010-02-26,Norway,1,USA,2,2,1,USA,Norway,2210,2001,209,-209
1002,2010-02-26,Iceland,1,Sweden,5,5,1,Sweden,Iceland,2067,1822,245,-245
1003,2010-02-26,Portugal,0,Romania,0,0,0,Portugal,Romania,1566,1583,-17,17
1004,2010-02-26,Austria,3,Faroe Islands,0,3,0,Austria,Faroe Islands,1572,1362,210,-210
1005,2010-02-26,Italy,2,Scotland,0,2,0,Italy,Scotland,1947,1726,221,-221
1006,2010-02-26,Netherlands,1,New Zealand,1,1,1,Netherlands,New Zealand,1838,1748,90,-90
1007,2010-02-26,Switzerland,3,South Africa,1,3,1,Switzerland,South Africa,1660,1409,251,-251
1008,2010-02-27,England,0,Canada,1,1,0,Canada,England,1939,1977,-38,38
1009,2010-03-01,China PR,0,Germany,5,5,0,Germany,China PR,2149,1938,211,-211
1010,2010-03-01,Denmark,2,Finland,1,2,1,Denmark,Finland,1955,1846,109,-109
1011,2010-03-01,USA,2,Sweden,0,2,0,USA,Sweden,2210,2067,143,-143
1012,2010-03-01,Iceland,2,Norway,3,3,2,Norway,Iceland,2001,1822,179,-179
1013,2010-03-01,Faroe Islands,1,Romania,5,5,1,Romania,Faroe Islands,1583,1362,221,-221
1014,2010-03-01,Portugal,2,Austria,1,2,1,Portugal,Austria,1566,1572,-6,6
1015,2010-03-01,New Zealand,3,Scotland,0,3,0,New Zealand,Scotland,1748,1726,22,-22
1016,2010-03-01,Italy,1,Netherlands,1,1,1,Italy,Netherlands,1947,1838,109,-109
1017,2010-03-01,South Africa,1,Canada,2,2,1,Canada,South Africa,1939,1409,530,-530
1018,2010-03-01,England,2,Switzerland,2,2,2,England,Switzerland,1977,1660,317,-317
1019,2010-03-03,Austria,6,Faroe Islands,0,6,0,Austria,Faroe Islands,1572,1362,210,-210
1020,2010-03-03,Portugal,0,Iceland,3,3,0,Iceland,Portugal,1822,1566,256,-256
1021,2010-03-03,Finland,0,Romania,1,1,0,Romania,Finland,1583,1846,-263,263
1022,2010-03-03,Denmark,2,Norway,1,2,1,Denmark,Norway,1955,2001,-46,46
1023,2010-03-03,China PR,0,Sweden,2,2,0,Sweden,China PR,2067,1938,129,-129
1024,2010-03-03,Germany,2,USA,3,3,2,USA,Germany,2210,2149,61,-61
1025,2010-03-03,Suriname,1,St Vincent and the Grenadines,0,1,0,Suriname,St Vincent and the Grenadines,1189,1035,154,-154
1026,2010-03-03,South Africa,1,Scotland,2,2,1,Scotland,South Africa,1726,1409,317,-317
1027,2010-03-03,England,3,Italy,2,3,2,England,Italy,1977,1947,30,-30
1028,2010-03-03,Netherlands,4,Switzerland,0,4,0,Netherlands,Switzerland,1838,1660,178,-178
1029,2010-03-03,New Zealand,0,Canada,1,1,0,Canada,New Zealand,1939,1748,191,-191
1030,2010-03-05,Guyana,2,Suriname,0,2,0,Guyana,Suriname,1346,1189,157,-157
1031,2010-03-06,Senegal,0,Morocco,0,0,0,Senegal,Morocco,1277,1366,-89,89
1032,2010-03-06,Ethiopia,1,Tanzania,3,3,1,Tanzania,Ethiopia,829,1111,-282,282
1033,2010-03-07,Namibia,2,Angola,1,2,1,Namibia,Angola,1017,1184,-167,167
1034,2010-03-07,Botswana,0,Congo DR,2,2,0,Congo DR,Botswana,1167,688,479,-479
1035,2010-03-07,Gabon,1,Côte d'Ivoire,2,2,1,Côte d'Ivoire,Gabon,1334,1031,303,-303
1036,2010-03-07,Guinea,3,Sierra Leone,2,3,2,Guinea,Sierra Leone,1054,1132,-78,78
1037,2010-03-07,Guyana,1,St Vincent and the Grenadines,0,1,0,Guyana,St Vincent and the Grenadines,1346,1035,311,-311
1038,2010-03-10,Antigua and Barbuda,1,St Lucia,2,2,1,St Lucia,Antigua and Barbuda,1061,761,300,-300
1039,2010-03-12,US Virgin Islands,0,St Lucia,7,7,0,St Lucia,US Virgin Islands,1061,852,209,-209
1040,2010-03-14,Antigua and Barbuda,3,US Virgin Islands,1,3,1,Antigua and Barbuda,US Virgin Islands,761,852,-91,91
1041,2010-03-17,St Kitts and Nevis,2,Dominica,0,2,0,St Kitts and Nevis,Dominica,974,936,38,-38
1042,2010-03-19,Congo DR,5,Botswana,2,5,2,Congo DR,Botswana,1167,703,464,-464
1043,2010-03-19,Côte d'Ivoire,3,Gabon,1,3,1,Côte d'Ivoire,Gabon,1334,1031,303,-303
1044,2010-03-19,Puerto Rico,7,St Kitts and Nevis,0,7,0,Puerto Rico,St Kitts and Nevis,1093,974,119,-119
1045,2010-03-21,Angola,1,Namibia,1,1,1,Angola,Namibia,1164,1037,127,-127
1046,2010-03-21,Puerto Rico,6,Dominica,0,6,0,Puerto Rico,Dominica,1093,936,157,-157
1047,2010-03-26,Dominican Republic,3,Turks and Caicos Islands,1,3,1,Dominican Republic,Turks and Caicos Islands,1239,704,535,-535
1048,2010-03-28,Turks and Caicos Islands,0,Haiti,5,5,0,Haiti,Turks and Caicos Islands,1398,704,694,-694
1049,2010-03-28,Barbados,3,Anguilla,0,3,0,Barbados,Anguilla,979,697,282,-282
1050,2010-03-30,Dominican Republic,1,Haiti,2,2,1,Haiti,Dominican Republic,1398,1239,159,-159
1051,2010-03-30,Anguilla,2,Grenada,0,2,0,Anguilla,Grenada,697,1029,-332,332
1052,2010-04-01,Barbados,4,Grenada,0,4,0,Barbados,Grenada,979,1029,-50,50
1053,2010-04-20,El Salvador,9,Belize,0,9,0,El Salvador,Belize,1106,882,224,-224
1054,2010-04-22,Guatemala,2,El Salvador,1,2,1,Guatemala,El Salvador,1300,1106,194,-194
1055,2010-04-24,Guatemala,5,Belize,1,5,1,Guatemala,Belize,1300,882,418,-418
1056,2010-04-26,Nicaragua,2,Honduras,1,2,1,Nicaragua,Honduras,1161,1198,-37,37
1057,2010-04-28,Honduras,0,Costa Rica,2,2,0,Costa Rica,Honduras,1518,1198,320,-320
1058,2010-04-30,Nicaragua,0,Costa Rica,2,2,0,Costa Rica,Nicaragua,1518,1161,357,-357
1059,2010-05-10,Guyana,3,Barbados,0,3,0,Guyana,Barbados,1346,979,367,-367
1060,2010-05-10,Trinidad and Tobago,6,St Lucia,1,6,1,Trinidad and Tobago,St Lucia,1536,1061,475,-475
1061,2010-05-11,Cuba,4,Puerto Rico,3,4,3,Cuba,Puerto Rico,1166,1093,73,-73
1062,2010-05-11,Antigua and Barbuda,1,Haiti,4,4,1,Haiti,Antigua and Barbuda,1398,761,637,-637
1063,2010-05-12,St Lucia,0,Guyana,8,8,0,Guyana,St Lucia,1346,1061,285,-285
1064,2010-05-12,Trinidad and Tobago,5,Barbados,0,5,0,Trinidad and Tobago,Barbados,1536,979,557,-557
1065,2010-05-13,Haiti,3,Cuba,0,3,0,Haiti,Cuba,1398,1166,232,-232
1066,2010-05-13,Puerto Rico,8,Antigua and Barbuda,0,8,0,Puerto Rico,Antigua and Barbuda,1093,761,332,-332
1067,2010-05-14,Barbados,4,St Lucia,3,4,3,Barbados,St Lucia,979,1061,-82,82
1068,2010-05-14,Trinidad and Tobago,3,Guyana,0,3,0,Trinidad and Tobago,Guyana,1536,1346,190,-190
1069,2010-05-15,Haiti,2,Puerto Rico,0,2,0,Haiti,Puerto Rico,1398,1093,305,-305
1070,2010-05-15,Cuba,6,Antigua and Barbuda,1,6,1,Cuba,Antigua and Barbuda,1166,761,405,-405
1071,2010-05-19,Australia,2,Vietnam,0,2,0,Australia,Vietnam,1909,1638,271,-271
1072,2010-05-19,China PR,0,Korea Republic,0,0,0,China PR,Korea Republic,1937,1794,143,-143
1073,2010-05-20,Korea DPR,3,Thailand,0,3,0,Korea DPR,Thailand,2015,1600,415,-415
1074,2010-05-20,Japan,8,Myanmar,0,8,0,Japan,Myanmar,2015,1542,473,-473
1075,2010-05-21,Congo DR,0,Cameroon,2,2,0,Cameroon,Congo DR,1300,1167,133,-133
1076,2010-05-21,Korea Republic,1,Australia,3,3,1,Australia,Korea Republic,1909,1794,115,-115
1077,2010-05-21,China PR,5,Vietnam,0,5,0,China PR,Vietnam,1937,1638,299,-299
1078,2010-05-22,Algeria,1,Tunisia,1,1,1,Algeria,Tunisia,1339,1320,19,-19
1079,2010-05-22,Senegal,0,Ghana,1,1,0,Ghana,Senegal,1523,1275,248,-248
1080,2010-05-22,Thailand,0,Japan,4,4,0,Japan,Thailand,2015,1600,415,-415
1081,2010-05-22,Myanmar,0,Korea DPR,2,2,0,Korea DPR,Myanmar,2015,1542,473,-473
1082,2010-05-23,Namibia,1,Equatorial Guinea,5,5,1,Equatorial Guinea,Namibia,1338,1037,301,-301
1083,2010-05-23,Côte d'Ivoire,1,Nigeria,2,2,1,Nigeria,Côte d'Ivoire,1652,1334,318,-318
1084,2010-05-23,Guinea,0,Mali,2,2,0,Mali,Guinea,1282,1054,228,-228
1085,2010-05-23,Tanzania,8,Eritrea,1,8,1,Tanzania,Eritrea,866,NA,NA,NA
1086,2010-05-23,China PR,1,Australia,0,1,0,China PR,Australia,1937,1909,28,-28
1087,2010-05-23,Vietnam,0,Korea Republic,5,5,0,Korea Republic,Vietnam,1794,1638,156,-156
1088,2010-05-24,Korea DPR,1,Japan,2,2,1,Japan,Korea DPR,2015,2015,0,0
1089,2010-05-24,Myanmar,0,Thailand,2,2,0,Thailand,Myanmar,1600,1542,58,-58
1090,2010-05-27,Japan,0,Australia,1,1,0,Australia,Japan,1909,2015,-106,106
1091,2010-05-27,China PR,0,Korea DPR,1,1,0,Korea DPR,China PR,2015,1937,78,-78
1092,2010-05-30,China PR,0,Japan,2,2,0,Japan,China PR,2022,1945,77,-77
1093,2010-05-30,Australia,1,Korea DPR,1,1,1,Australia,Korea DPR,1916,2015,-99,99
1094,2010-06-05,Tunisia,0,Algeria,1,1,0,Algeria,Tunisia,1332,1327,5,-5
1095,2010-06-05,Cameroon,3,Congo DR,0,3,0,Cameroon,Congo DR,1317,1149,168,-168
1096,2010-06-05,Nigeria,3,Côte d'Ivoire,1,3,1,Nigeria,Côte d'Ivoire,1656,1331,325,-325
1097,2010-06-05,Mali,1,Guinea,2,2,1,Guinea,Mali,1043,1293,-250,250
1098,2010-06-05,Eritrea,3,Tanzania,3,3,3,Eritrea,Tanzania,NA,873,NA,NA
1099,2010-06-06,Ghana,3,Senegal,0,3,0,Ghana,Senegal,1531,1294,237,-237
1100,2010-06-26,Cuba,1,Guyana,0,1,0,Cuba,Guyana,1168,1346,-178,178
1101,2010-07-03,Guyana,3,Cuba,1,3,1,Guyana,Cuba,1346,1168,178,-178
1102,2010-09-29,New Zealand,14,Vanuatu,0,14,0,New Zealand,Vanuatu,1752,1208,544,-544
1103,2010-09-29,Cook Islands,1,Tahiti,0,1,0,Cook Islands,Tahiti,1087,1258,-171,171
1104,2010-09-30,Papua New Guinea,3,Fiji,0,3,0,Papua New Guinea,Fiji,1414,1335,79,-79
1105,2010-09-30,Solomon Islands,4,Tonga,0,4,0,Solomon Islands,Tonga,1194,1392,-198,198
1106,2010-10-01,Tahiti,5,Vanuatu,1,5,1,Tahiti,Vanuatu,1258,1208,50,-50
1107,2010-10-01,New Zealand,10,Cook Islands,0,10,0,New Zealand,Cook Islands,1752,1087,665,-665
1108,2010-10-02,Tonga,2,Fiji,1,2,1,Tonga,Fiji,1392,1335,57,-57
1109,2010-10-02,Solomon Islands,1,Papua New Guinea,2,2,1,Papua New Guinea,Solomon Islands,1414,1194,220,-220
1110,2010-10-03,New Zealand,7,Tahiti,0,7,0,New Zealand,Tahiti,1752,1258,494,-494
1111,2010-10-03,Vanuatu,0,Cook Islands,2,2,0,Cook Islands,Vanuatu,1087,1208,-121,121
1112,2010-10-04,Tonga,0,Papua New Guinea,3,3,0,Papua New Guinea,Tonga,1414,1392,22,-22
1113,2010-10-04,Fiji,0,Solomon Islands,0,0,0,Fiji,Solomon Islands,1335,1194,141,-141
1114,2010-10-06,New Zealand,8,Solomon Islands,0,8,0,New Zealand,Solomon Islands,1752,1194,558,-558
1115,2010-10-06,Papua New Guinea,1,Cook Islands,0,1,0,Papua New Guinea,Cook Islands,1414,1087,327,-327
1116,2010-10-08,Solomon Islands,0,Cook Islands,2,2,0,Cook Islands,Solomon Islands,1087,1194,-107,107
1117,2010-10-08,New Zealand,11,Papua New Guinea,0,11,0,New Zealand,Papua New Guinea,1752,1414,338,-338
1118,2010-10-28,Costa Rica,1,Guatemala,0,1,0,Costa Rica,Guatemala,1520,1301,219,-219
1119,2010-10-28,USA,5,Haiti,0,5,0,USA,Haiti,2227,1397,830,-830
1120,2010-10-29,Trinidad and Tobago,0,Canada,1,1,0,Canada,Trinidad and Tobago,1946,1521,425,-425
1121,2010-10-29,Mexico,7,Guyana,2,7,2,Mexico,Guyana,1775,1262,513,-513
1122,2010-10-30,Haiti,0,Costa Rica,3,3,0,Costa Rica,Haiti,1520,1397,123,-123
1123,2010-10-30,USA,9,Guatemala,0,9,0,USA,Guatemala,2227,1301,926,-926
1124,2010-10-31,South Africa,2,Tanzania,1,2,1,South Africa,Tanzania,1411,873,538,-538
1125,2010-10-31,Canada,8,Guyana,0,8,0,Canada,Guyana,1946,1262,684,-684
1126,2010-10-31,Mexico,2,Trinidad and Tobago,0,2,0,Mexico,Trinidad and Tobago,1775,1521,254,-254
1127,2010-11-01,Guatemala,0,Haiti,1,1,0,Haiti,Guatemala,1397,1301,96,-96
1128,2010-11-01,USA,4,Costa Rica,0,4,0,USA,Costa Rica,2227,1520,707,-707
1129,2010-11-01,Nigeria,5,Mali,0,5,0,Nigeria,Mali,1656,1260,396,-396
1130,2010-11-02,Guyana,1,Trinidad and Tobago,4,4,1,Trinidad and Tobago,Guyana,1521,1262,259,-259
1131,2010-11-02,Mexico,0,Canada,3,3,0,Canada,Mexico,1946,1775,171,-171
1132,2010-11-02,Equatorial Guinea,2,Cameroon,2,2,2,Equatorial Guinea,Cameroon,1348,1323,25,-25
1133,2010-11-02,Algeria,1,Ghana,2,2,1,Ghana,Algeria,1535,1354,181,-181
1134,2010-11-03,Morocco,0,Senegal,1,1,0,Senegal,Morocco,1290,1338,-48,48
1135,2010-11-03,Sierra Leone,1,Guinea,1,1,1,Sierra Leone,Guinea,1132,1076,56,-56
1136,2010-11-03,Tanzania,1,Ethiopia,1,1,1,Tanzania,Ethiopia,873,1067,-194,194
1137,2010-11-04,Argentina,3,Bolivia,0,3,0,Argentina,Bolivia,1649,1210,439,-439
1138,2010-11-04,Ecuador,1,Chile,2,2,1,Chile,Ecuador,1481,1473,8,-8
1139,2010-11-04,South Africa,1,Nigeria,2,2,1,Nigeria,South Africa,1656,1411,245,-245
1140,2010-11-04,Mali,3,Tanzania,2,3,2,Mali,Tanzania,1260,873,387,-387
1141,2010-11-05,Paraguay,0,Colombia,3,3,0,Colombia,Paraguay,1577,1401,176,-176
1142,2010-11-05,Brazil,4,Venezuela,0,4,0,Brazil,Venezuela,2124,1337,787,-787
1143,2010-11-05,Canada,4,Costa Rica,0,4,0,Canada,Costa Rica,1946,1520,426,-426
1144,2010-11-05,Mexico,2,USA,1,2,1,Mexico,USA,1775,2227,-452,452
1145,2010-11-05,Equatorial Guinea,1,Algeria,0,1,0,Equatorial Guinea,Algeria,1348,1354,-6,6
1146,2010-11-05,Ghana,1,Cameroon,2,2,1,Cameroon,Ghana,1323,1535,-212,212
1147,2010-11-06,Chile,1,Argentina,2,2,1,Argentina,Chile,1649,1481,168,-168
1148,2010-11-06,Ecuador,2,Peru,1,2,1,Ecuador,Peru,1473,1522,-49,49
1149,2010-11-07,Venezuela,0,Paraguay,4,4,0,Paraguay,Venezuela,1401,1337,64,-64
1150,2010-11-07,Uruguay,0,Brazil,4,4,0,Brazil,Uruguay,2124,1401,723,-723
1151,2010-11-07,South Africa,4,Mali,0,4,0,South Africa,Mali,1411,1260,151,-151
1152,2010-11-07,Tanzania,0,Nigeria,3,3,0,Nigeria,Tanzania,1656,873,783,-783
1153,2010-11-08,Chile,3,Bolivia,0,3,0,Chile,Bolivia,1481,1210,271,-271
1154,2010-11-08,Argentina,2,Peru,0,2,0,Argentina,Peru,1649,1522,127,-127
1155,2010-11-08,Costa Rica,0,USA,3,3,0,USA,Costa Rica,2227,1520,707,-707
1156,2010-11-08,Mexico,0,Canada,1,1,0,Canada,Mexico,1946,1775,171,-171
1157,2010-11-08,Ghana,1,Equatorial Guinea,3,3,1,Equatorial Guinea,Ghana,1348,1535,-187,187
1158,2010-11-08,Cameroon,2,Algeria,1,2,1,Cameroon,Algeria,1323,1354,-31,31
1159,2010-11-09,Colombia,5,Venezuela,0,5,0,Colombia,Venezuela,1577,1337,240,-240
1160,2010-11-09,Paraguay,4,Uruguay,0,4,0,Paraguay,Uruguay,1401,1401,0,0
1161,2010-11-10,Peru,1,Chile,3,3,1,Chile,Peru,1481,1522,-41,41
1162,2010-11-10,Ecuador,4,Bolivia,3,4,3,Ecuador,Bolivia,1473,1210,263,-263
1163,2010-11-11,Venezuela,5,Uruguay,2,5,2,Venezuela,Uruguay,1337,1401,-64,64
1164,2010-11-11,Colombia,1,Brazil,2,2,1,Brazil,Colombia,2124,1577,547,-547
1165,2010-11-11,Nigeria,5,Cameroon,1,5,1,Nigeria,Cameroon,1656,1323,333,-333
1166,2010-11-11,South Africa,1,Equatorial Guinea,3,3,1,Equatorial Guinea,South Africa,1348,1411,-63,63
1167,2010-11-12,Bolivia,2,Peru,1,2,1,Bolivia,Peru,1210,1522,-312,312
1168,2010-11-12,Ecuador,1,Argentina,0,1,0,Ecuador,Argentina,1473,1649,-176,176
1169,2010-11-13,Uruguay,0,Colombia,8,8,0,Colombia,Uruguay,1577,1401,176,-176
1170,2010-11-13,Brazil,3,Paraguay,0,3,0,Brazil,Paraguay,2124,1401,723,-723
1171,2010-11-14,South Africa,2,Cameroon,0,2,0,South Africa,Cameroon,1411,1323,88,-88
1172,2010-11-14,Nigeria,4,Equatorial Guinea,2,4,2,Nigeria,Equatorial Guinea,1656,1348,308,-308
1173,2010-11-17,Chile,1,Colombia,1,1,1,Chile,Colombia,1481,1577,-96,96
1174,2010-11-17,Brazil,4,Argentina,0,4,0,Brazil,Argentina,2124,1649,475,-475
1175,2010-11-19,Chile,0,Argentina,0,0,0,Chile,Argentina,1481,1649,-168,168
1175,2010-11-19,Chile,0,Argentina,0,0,0,Chile,Argentina,1481,1644,-163,163
1175,2010-11-19,Chile,0,Argentina,0,0,0,Chile,Argentina,1517,1649,-132,132
1175,2010-11-19,Chile,0,Argentina,0,0,0,Chile,Argentina,1517,1644,-127,127
1176,2010-11-19,Brazil,5,Colombia,0,5,0,Brazil,Colombia,2124,1577,547,-547
1176,2010-11-19,Brazil,5,Colombia,0,5,0,Brazil,Colombia,2124,1611,513,-513
1176,2010-11-19,Brazil,5,Colombia,0,5,0,Brazil,Colombia,2116,1577,539,-539
1176,2010-11-19,Brazil,5,Colombia,0,5,0,Brazil,Colombia,2116,1611,505,-505
1177,2010-11-21,Colombia,1,Argentina,0,1,0,Colombia,Argentina,1611,1644,-33,33
1178,2010-11-21,Chile,1,Brazil,3,3,1,Brazil,Chile,2116,1517,599,-599
1179,2011-01-21,Sweden,2,USA,1,2,1,Sweden,USA,2063,2185,-122,122
1180,2011-01-21,China PR,2,Canada,3,3,2,Canada,China PR,1974,1916,58,-58
1181,2011-01-23,China PR,2,Sweden,1,2,1,China PR,Sweden,1916,2063,-147,147
1182,2011-01-23,USA,2,Canada,1,2,1,USA,Canada,2185,1974,211,-211
1183,2011-01-25,Canada,1,Sweden,0,1,0,Canada,Sweden,1974,2063,-89,89
1184,2011-01-25,China PR,0,USA,2,2,0,USA,China PR,2185,1916,269,-269
1185,2011-03-02,Norway,2,Finland,1,2,1,Norway,Finland,2002,1828,174,-174
1186,2011-03-02,USA,2,Japan,1,2,1,USA,Japan,2185,2036,149,-149
1187,2011-03-02,Sweden,1,Iceland,2,2,1,Iceland,Sweden,1824,2063,-239,239
1188,2011-03-02,China PR,0,Denmark,1,1,0,Denmark,China PR,1895,1916,-21,21
1189,2011-03-02,Portugal,3,Wales,1,3,1,Portugal,Wales,1564,1509,55,-55
1190,2011-03-02,Romania,2,Chile,0,2,0,Romania,Chile,1577,1517,60,-60
1191,2011-03-02,Canada,1,Scotland,0,1,0,Canada,Scotland,1974,1753,221,-221
1192,2011-03-02,England,2,Italy,0,2,0,England,Italy,1973,1952,21,-21
1193,2011-03-02,France,2,Switzerland,0,2,0,France,Switzerland,1998,1736,262,-262
1194,2011-03-02,New Zealand,1,Netherlands,4,4,1,Netherlands,New Zealand,1871,1764,107,-107
1195,2011-03-02,Korea Republic,3,Northern Ireland,1,3,1,Korea Republic,Northern Ireland,1820,1389,431,-431
1196,2011-03-02,Russia,0,Mexico,0,0,0,Russia,Mexico,1815,1781,34,-34
1197,2011-03-03,FYR Macedonia,1,Lithuania,1,1,1,FYR Macedonia,Lithuania,1009,1320,-311,311
1198,2011-03-03,Luxembourg,2,Latvia,0,2,0,Luxembourg,Latvia,1214,1234,-20,20
1199,2011-03-03,Malta,1,Georgia,0,1,0,Malta,Georgia,1114,1053,61,-61
1200,2011-03-03,Faroe Islands,0,Armenia,1,1,0,Armenia,Faroe Islands,1086,1351,-265,265
1201,2011-03-04,Japan,5,Finland,0,5,0,Japan,Finland,2036,1828,208,-208
1202,2011-03-04,USA,2,Norway,0,2,0,USA,Norway,2185,2002,183,-183
1203,2011-03-04,Iceland,2,China PR,1,2,1,Iceland,China PR,1824,1916,-92,92
1204,2011-03-04,Denmark,1,Sweden,3,3,1,Sweden,Denmark,2063,1895,168,-168
1205,2011-03-04,Portugal,0,Chile,0,0,0,Portugal,Chile,1564,1517,47,-47
1206,2011-03-04,Wales,2,Romania,1,2,1,Wales,Romania,1509,1577,-68,68
1207,2011-03-04,England,0,Scotland,2,2,0,Scotland,England,1753,1973,-220,220
1208,2011-03-04,Italy,0,Canada,1,1,0,Canada,Italy,1974,1952,22,-22
1209,2011-03-04,France,1,Netherlands,2,2,1,Netherlands,France,1871,1998,-127,127
1210,2011-03-04,Switzerland,1,New Zealand,2,2,1,New Zealand,Switzerland,1764,1736,28,-28
1211,2011-03-04,Russia,2,Northern Ireland,1,2,1,Russia,Northern Ireland,1815,1389,426,-426
1212,2011-03-04,Korea Republic,1,Mexico,1,1,1,Korea Republic,Mexico,1820,1781,39,-39
1213,2011-03-05,FYR Macedonia,5,Luxembourg,1,5,1,FYR Macedonia,Luxembourg,1009,1214,-205,205
1214,2011-03-05,Latvia,1,Lithuania,0,1,0,Latvia,Lithuania,1234,1320,-86,86
1215,2011-03-05,Armenia,0,Georgia,0,0,0,Armenia,Georgia,1086,1053,33,-33
1216,2011-03-05,Malta,0,Faroe Islands,2,2,0,Faroe Islands,Malta,1351,1114,237,-237
1217,2011-03-07,Norway,0,Japan,1,1,0,Japan,Norway,2036,2002,34,-34
1218,2011-03-07,USA,4,Finland,0,4,0,USA,Finland,2185,1828,357,-357
1219,2011-03-07,China PR,0,Sweden,1,1,0,Sweden,China PR,2063,1916,147,-147
1220,2011-03-07,Denmark,0,Iceland,1,1,0,Iceland,Denmark,1824,1895,-71,71
1221,2011-03-07,Chile,1,Wales,2,2,1,Wales,Chile,1509,1517,-8,8
1222,2011-03-07,Portugal,1,Romania,1,1,1,Portugal,Romania,1564,1577,-13,13
1223,2011-03-07,Scotland,0,Italy,0,0,0,Scotland,Italy,1753,1952,-199,199
1224,2011-03-07,Canada,2,England,0,2,0,Canada,England,1974,1973,1,-1
1225,2011-03-07,Netherlands,6,Switzerland,0,6,0,Netherlands,Switzerland,1871,1736,135,-135
1226,2011-03-07,New Zealand,2,France,5,5,2,France,New Zealand,1998,1764,234,-234
1227,2011-03-07,Mexico,3,Northern Ireland,1,3,1,Mexico,Northern Ireland,1781,1389,392,-392
1228,2011-03-07,Russia,1,Korea Republic,2,2,1,Korea Republic,Russia,1820,1815,5,-5
1229,2011-03-08,Lithuania,4,Luxembourg,1,4,1,Lithuania,Luxembourg,1320,1214,106,-106
1230,2011-03-08,FYR Macedonia,1,Latvia,0,1,0,FYR Macedonia,Latvia,1009,1234,-225,225
1231,2011-03-08,Georgia,1,Faroe Islands,0,1,0,Georgia,Faroe Islands,1053,1351,-298,298
1232,2011-03-08,Malta,1,Armenia,1,1,1,Malta,Armenia,1114,1086,28,-28
1233,2011-03-09,Romania,1,Chile,1,1,1,Romania,Chile,1577,1517,60,-60
1234,2011-03-09,Portugal,2,Finland,1,2,1,Portugal,Finland,1564,1828,-264,264
1235,2011-03-09,China PR,2,Wales,1,2,1,China PR,Wales,1916,1509,407,-407
1236,2011-03-09,Norway,0,Denmark,0,0,0,Norway,Denmark,2002,1895,107,-107
1237,2011-03-09,Sweden,1,Japan,2,2,1,Japan,Sweden,2036,2063,-27,27
1238,2011-03-09,Iceland,2,USA,4,4,2,USA,Iceland,2185,1824,361,-361
1239,2011-03-09,Switzerland,2,Northern Ireland,1,2,1,Switzerland,Northern Ireland,1736,1389,347,-347
1240,2011-03-09,Italy,2,Russia,0,2,0,Italy,Russia,1952,1815,137,-137
1241,2011-03-09,New Zealand,0,Mexico,5,5,0,Mexico,New Zealand,1781,1764,17,-17
1242,2011-03-09,England,2,Korea Republic,0,2,0,England,Korea Republic,1973,1820,153,-153
1243,2011-03-09,Scotland,0,France,3,3,0,France,Scotland,1998,1753,245,-245
1244,2011-03-09,Canada,2,Netherlands,1,2,1,Canada,Netherlands,1974,1871,103,-103
1245,2011-05-19,Iceland,6,Bulgaria,0,6,0,Iceland,Bulgaria,1846,1495,351,-351
1246,2011-06-26,Nigeria,0,France,1,1,0,France,Nigeria,1997,1672,325,-325
1247,2011-06-26,Germany,2,Canada,1,2,1,Germany,Canada,2153,2028,125,-125
1248,2011-06-27,Japan,2,New Zealand,1,2,1,Japan,New Zealand,2062,1750,312,-312
1249,2011-06-27,Mexico,1,England,1,1,1,Mexico,England,1781,1962,-181,181
1250,2011-06-28,Colombia,0,Sweden,1,1,0,Sweden,Colombia,2043,1621,422,-422
1251,2011-06-28,USA,2,Korea DPR,0,2,0,USA,Korea DPR,2191,1995,196,-196
1252,2011-06-29,Norway,1,Equatorial Guinea,0,1,0,Norway,Equatorial Guinea,1989,1396,593,-593
1253,2011-06-29,Brazil,1,Australia,0,1,0,Brazil,Australia,2098,1945,153,-153
1254,2011-06-30,Canada,0,France,4,4,0,France,Canada,1997,2028,-31,31
1255,2011-06-30,Germany,1,Nigeria,0,1,0,Germany,Nigeria,2153,1672,481,-481
1256,2011-07-01,Japan,4,Mexico,0,4,0,Japan,Mexico,2062,1781,281,-281
1257,2011-07-01,New Zealand,1,England,2,2,1,England,New Zealand,1962,1750,212,-212
1258,2011-07-02,Korea DPR,0,Sweden,1,1,0,Sweden,Korea DPR,2043,1995,48,-48
1259,2011-07-02,USA,3,Colombia,0,3,0,USA,Colombia,2191,1621,570,-570
1260,2011-07-03,Australia,3,Equatorial Guinea,2,3,2,Australia,Equatorial Guinea,1945,1396,549,-549
1261,2011-07-03,Brazil,3,Norway,0,3,0,Brazil,Norway,2098,1989,109,-109
1262,2011-07-05,Germany,4,France,2,4,2,Germany,France,2153,1997,156,-156
1263,2011-07-05,Canada,0,Nigeria,1,1,0,Nigeria,Canada,1672,2028,-356,356
1264,2011-07-05,England,2,Japan,0,2,0,England,Japan,1962,2062,-100,100
1265,2011-07-05,New Zealand,2,Mexico,2,2,2,New Zealand,Mexico,1750,1781,-31,31
1266,2011-07-06,Sweden,2,USA,1,2,1,Sweden,USA,2043,2191,-148,148
1267,2011-07-06,Korea DPR,0,Colombia,0,0,0,Korea DPR,Colombia,1995,1621,374,-374
1268,2011-07-06,Equatorial Guinea,0,Brazil,3,3,0,Brazil,Equatorial Guinea,2098,1396,702,-702
1269,2011-07-06,Australia,2,Norway,1,2,1,Australia,Norway,1945,1989,-44,44
1270,2011-07-09,England,1,France,1,1,1,England,France,1962,1997,-35,35
1271,2011-07-09,Germany,0,Japan,1,1,0,Japan,Germany,2062,2153,-91,91
1272,2011-07-10,Sweden,3,Australia,1,3,1,Sweden,Australia,2043,1945,98,-98
1273,2011-07-10,Brazil,2,USA,2,2,2,Brazil,USA,2098,2191,-93,93
1274,2011-07-13,France,1,USA,3,3,1,USA,France,2191,1997,194,-194
1275,2011-07-13,Japan,3,Sweden,1,3,1,Japan,Sweden,2062,2043,19,-19
1276,2011-07-16,Sweden,2,France,1,2,1,Sweden,France,2043,1997,46,-46
1277,2011-07-17,Japan,2,USA,2,2,2,Japan,USA,2062,2191,-129,129
1278,2011-08-25,Belarus,2,Estonia,1,2,1,Belarus,Estonia,1566,1331,235,-235
1279,2011-09-14,Israel,0,France,5,5,0,France,Israel,1981,1398,583,-583
1280,2011-09-17,Bosnia and Herzegovina,0,Italy,1,1,0,Italy,Bosnia and Herzegovina,1934,1233,701,-701
1281,2011-09-17,Kazakhstan,0,Romania,3,3,0,Romania,Kazakhstan,1572,1326,246,-246
1282,2011-09-17,Germany,4,Switzerland,1,4,1,Germany,Switzerland,2146,1729,417,-417
1283,2011-09-17,Turkey,1,Spain,10,10,1,Spain,Turkey,1816,1388,428,-428
1284,2011-09-17,Belgium,2,Hungary,1,2,1,Belgium,Hungary,1607,1632,-25,25
1285,2011-09-17,Iceland,3,Norway,1,3,1,Iceland,Norway,1848,1940,-92,92
1286,2011-09-17,Wales,0,Republic of Ireland,2,2,0,Republic of Ireland,Wales,1642,1515,127,-127
1287,2011-09-17,Serbia,2,England,2,2,2,Serbia,England,1525,1997,-472,472
1288,2011-09-17,Armenia,0,Portugal,8,8,0,Portugal,Armenia,1573,1107,466,-466
1289,2011-09-17,Austria,1,Czech Republic,1,1,1,Austria,Czech Republic,1570,1739,-169,169
1290,2011-09-18,Estonia,1,Ukraine,4,4,1,Ukraine,Estonia,1799,1331,468,-468
1291,2011-09-21,Poland,0,Russia,20,20,0,Russia,Poland,1809,1645,164,-164
1292,2011-09-21,Switzerland,4,Romania,1,4,1,Switzerland,Romania,1729,1572,157,-157
1293,2011-09-21,Norway,6,Hungary,0,6,0,Norway,Hungary,1940,1632,308,-308
1294,2011-09-21,Iceland,0,Belgium,0,0,0,Iceland,Belgium,1848,1607,241,-241
1295,2011-09-21,Netherlands,6,Serbia,0,6,0,Netherlands,Serbia,1888,1525,363,-363
1296,2011-09-21,Armenia,0,Denmark,5,5,0,Denmark,Armenia,1888,1107,781,-781
1297,2011-09-22,Kazakhstan,2,Turkey,0,2,0,Kazakhstan,Turkey,1326,1388,-62,62
1298,2011-09-22,Republic of Ireland,1,France,3,3,1,France,Republic of Ireland,1981,1642,339,-339
1299,2011-09-22,England,4,Slovenia,0,4,0,England,Slovenia,1997,1394,603,-603
1300,2011-10-22,Russia,4,Bosnia and Herzegovina,1,4,1,Russia,Bosnia and Herzegovina,1802,1236,566,-566
1301,2011-10-22,FYR Macedonia,0,Italy,9,9,0,Italy,FYR Macedonia,1930,1050,880,-880
1302,2011-10-22,Poland,2,Greece,0,2,0,Poland,Greece,1645,1427,218,-218
1303,2011-10-22,Turkey,0,Kazakhstan,0,0,0,Turkey,Kazakhstan,1383,1319,64,-64
1304,2011-10-22,Romania,0,Germany,3,3,0,Germany,Romania,2146,1590,556,-556
1305,2011-10-22,Hungary,0,Iceland,1,1,0,Iceland,Hungary,1860,1615,245,-245
1306,2011-10-22,Bulgaria,0,Northern Ireland,1,1,0,Northern Ireland,Bulgaria,1385,1493,-108,108
1307,2011-10-22,Republic of Ireland,2,Israel,0,2,0,Republic of Ireland,Israel,1648,1397,251,-251
1308,2011-10-22,Wales,1,France,4,4,1,France,Wales,1982,1509,473,-473
1309,2011-10-22,Ukraine,0,Slovakia,0,0,0,Ukraine,Slovakia,1801,1551,250,-250
1310,2011-10-22,Finland,6,Estonia,0,6,0,Finland,Estonia,1813,1330,483,-483
1311,2011-10-22,Croatia,0,Netherlands,3,3,0,Netherlands,Croatia,1897,1390,507,-507
1312,2011-10-22,Slovenia,1,Serbia,2,2,1,Serbia,Slovenia,1537,1389,148,-148
1313,2011-10-22,Czech Republic,1,Portugal,0,1,0,Czech Republic,Portugal,1729,1577,152,-152
1314,2011-10-22,Denmark,3,Austria,0,3,0,Denmark,Austria,1888,1563,325,-325
1315,2011-10-23,Spain,3,Switzerland,2,3,2,Spain,Switzerland,1819,1730,89,-89
1316,2011-10-26,FYR Macedonia,1,Greece,1,1,1,FYR Macedonia,Greece,1050,1427,-377,377
1317,2011-10-26,Italy,2,Russia,0,2,0,Italy,Russia,1930,1802,128,-128
1318,2011-10-26,Poland,4,Bosnia and Herzegovina,0,4,0,Poland,Bosnia and Herzegovina,1645,1236,409,-409
1319,2011-10-26,Belgium,0,Norway,1,1,0,Norway,Belgium,1928,1620,308,-308
1320,2011-10-26,Northern Ireland,0,Iceland,2,2,0,Iceland,Northern Ireland,1860,1385,475,-475
1321,2011-10-26,France,5,Israel,0,5,0,France,Israel,1982,1397,585,-585
1322,2011-10-26,Slovakia,3,Estonia,1,3,1,Slovakia,Estonia,1551,1330,221,-221
1323,2011-10-26,Austria,3,Armenia,0,3,0,Austria,Armenia,1563,1104,459,-459
1324,2011-10-26,Portugal,0,Denmark,3,3,0,Denmark,Portugal,1888,1577,311,-311
1325,2011-10-27,Kazakhstan,0,Spain,4,4,0,Spain,Kazakhstan,1819,1319,500,-500
1326,2011-10-27,Romania,7,Turkey,1,7,1,Romania,Turkey,1590,1383,207,-207
1327,2011-10-27,Bulgaria,0,Hungary,4,4,0,Hungary,Bulgaria,1615,1493,122,-122
1328,2011-10-27,Scotland,2,Wales,2,2,2,Scotland,Wales,1772,1509,263,-263
1329,2011-10-27,Belarus,2,Finland,2,2,2,Belarus,Finland,1565,1813,-248,248
1330,2011-10-27,Croatia,3,Slovenia,3,3,3,Croatia,Slovenia,1390,1389,1,-1
1331,2011-10-27,Netherlands,0,England,0,0,0,Netherlands,England,1897,1985,-88,88
1332,2011-11-19,FYR Macedonia,2,Bosnia and Herzegovina,6,6,2,Bosnia and Herzegovina,FYR Macedonia,1236,1050,186,-186
1333,2011-11-19,Greece,0,Russia,4,4,0,Russia,Greece,1802,1427,375,-375
1334,2011-11-19,Poland,0,Italy,5,5,0,Italy,Poland,1930,1645,285,-285
1335,2011-11-19,Germany,17,Kazakhstan,0,17,0,Germany,Kazakhstan,2146,1319,827,-827
1336,2011-11-19,Belgium,5,Bulgaria,0,5,0,Belgium,Bulgaria,1620,1493,127,-127
1337,2011-11-19,Northern Ireland,3,Norway,1,3,1,Northern Ireland,Norway,1385,1928,-543,543
1338,2011-11-19,Slovakia,3,Belarus,0,3,0,Slovakia,Belarus,1551,1565,-14,14
1339,2011-11-19,Serbia,4,Croatia,2,4,2,Serbia,Croatia,1537,1390,147,-147
1340,2011-11-19,Slovenia,0,Netherlands,2,2,0,Netherlands,Slovenia,1897,1389,508,-508
1341,2011-11-19,Portugal,0,Austria,1,1,0,Austria,Portugal,1563,1577,-14,14
1342,2011-11-20,Romania,0,Spain,4,4,0,Spain,Romania,1819,1590,229,-229
1343,2011-11-20,Israel,0,Wales,2,2,0,Wales,Israel,1509,1397,112,-112
1344,2011-11-20,Czech Republic,5,Armenia,0,5,0,Czech Republic,Armenia,1729,1104,625,-625
1345,2011-11-23,FYR Macedonia,0,Poland,3,3,0,Poland,FYR Macedonia,1645,1050,595,-595
1346,2011-11-23,Italy,2,Greece,0,2,0,Italy,Greece,1930,1427,503,-503
1347,2011-11-23,Turkey,1,Romania,2,2,1,Romania,Turkey,1590,1383,207,-207
1348,2011-11-23,Bulgaria,0,Belgium,1,1,0,Belgium,Bulgaria,1620,1493,127,-127
1349,2011-11-23,Hungary,2,Northern Ireland,2,2,2,Hungary,Northern Ireland,1615,1385,230,-230
1350,2011-11-23,England,2,Serbia,0,2,0,England,Serbia,1985,1537,448,-448
1351,2011-11-23,Denmark,11,Armenia,0,11,0,Denmark,Armenia,1888,1104,784,-784
1352,2011-11-24,Switzerland,8,Kazakhstan,1,8,1,Switzerland,Kazakhstan,1730,1319,411,-411
1353,2011-11-24,Spain,2,Germany,2,2,2,Spain,Germany,1819,2146,-327,327
1354,2011-11-24,Ukraine,0,Belarus,1,1,0,Belarus,Ukraine,1565,1801,-236,236
1355,2011-11-24,Netherlands,2,Croatia,0,2,0,Netherlands,Croatia,1897,1390,507,-507
1356,2011-12-20,Israel,1,Scotland,6,6,1,Scotland,Israel,1772,1397,375,-375
1357,2012-01-14,Egypt,4,Ethiopia,2,4,2,Egypt,Ethiopia,1304,1136,168,-168
1358,2012-01-14,Namibia,0,Tanzania,2,2,0,Tanzania,Namibia,915,1051,-136,136
1359,2012-01-14,Côte d'Ivoire,5,Guinea,1,5,1,Côte d'Ivoire,Guinea,1331,1073,258,-258
1360,2012-01-14,Zambia,7,Malawi,0,7,0,Zambia,Malawi,952,833,119,-119
1361,2012-01-14,Morocco,2,Tunisia,0,2,0,Morocco,Tunisia,1340,1323,17,-17
1362,2012-01-14,Botswana,0,Zimbabwe,1,1,0,Zimbabwe,Botswana,1180,703,477,-477
1363,2012-01-14,Uganda,1,Congo DR,1,1,1,Uganda,Congo DR,965,1113,-148,148
1364,2012-01-15,Mali,0,Ghana,3,3,0,Ghana,Mali,1457,1215,242,-242
1365,2012-01-21,Dominican Republic,0,USA,14,14,0,USA,Dominican Republic,2148,1256,892,-892
1366,2012-01-23,USA,13,Guatemala,0,13,0,USA,Guatemala,2148,1293,855,-855
1367,2012-01-25,USA,4,Mexico,0,4,0,USA,Mexico,2148,1778,370,-370
1368,2012-01-28,USA,3,Costa Rica,0,3,0,USA,Costa Rica,2148,1557,591,-591
1369,2012-01-28,Tunisia,2,Morocco,0,2,0,Tunisia,Morocco,1323,1340,-17,17
1370,2012-01-28,Congo DR,4,Uganda,0,4,0,Congo DR,Uganda,1113,965,148,-148
1371,2012-01-29,Ethiopia,4,Egypt,0,4,0,Ethiopia,Egypt,1136,1304,-168,168
1372,2012-01-29,Tanzania,5,Namibia,2,5,2,Tanzania,Namibia,915,1051,-136,136
1373,2012-01-29,Guinea,0,Côte d'Ivoire,5,5,0,Côte d'Ivoire,Guinea,1331,1073,258,-258
1374,2012-01-29,Malawi,4,Zambia,2,4,2,Malawi,Zambia,833,952,-119,119
1375,2012-01-29,Zimbabwe,2,Botswana,1,2,1,Zimbabwe,Botswana,1180,703,477,-477
1376,2012-01-29,Ghana,5,Mali,0,5,0,Ghana,Mali,1457,1215,242,-242
1377,2012-01-30,Canada,0,USA,4,4,0,USA,Canada,2148,1989,159,-159
1378,2012-02-12,USA,2,New Zealand,1,2,1,USA,New Zealand,2148,1752,396,-396
1379,2012-02-15,Greece,2,Bosnia and Herzegovina,3,3,2,Bosnia and Herzegovina,Greece,1247,1413,-166,166
1380,2012-02-15,Turkey,0,Germany,5,5,0,Germany,Turkey,2143,1356,787,-787
1381,2012-02-15,Belgium,2,Northern Ireland,2,2,2,Belgium,Northern Ireland,1639,1437,202,-202
1382,2012-02-15,Portugal,6,Armenia,0,6,0,Portugal,Armenia,1555,1104,451,-451
1383,2012-02-15,China PR,1,Mexico,0,1,0,China PR,Mexico,1831,1778,53,-53
1384,2012-02-15,Korea Republic,0,Korea DPR,1,1,0,Korea DPR,Korea Republic,1967,1845,122,-122
1385,2012-02-17,China PR,0,Korea Republic,0,0,0,China PR,Korea Republic,1831,1845,-14,14
1386,2012-02-17,Mexico,0,Korea DPR,1,1,0,Korea DPR,Mexico,1967,1778,189,-189
1387,2012-02-19,China PR,0,Korea DPR,0,0,0,China PR,Korea DPR,1831,1967,-136,136
1388,2012-02-19,Mexico,2,Korea Republic,3,3,2,Korea Republic,Mexico,1845,1778,67,-67
1389,2012-02-28,France,3,Switzerland,0,3,0,France,Switzerland,1990,1733,257,-257
1390,2012-02-28,England,3,Finland,1,3,1,England,Finland,1983,1802,181,-181
1391,2012-02-28,Netherlands,2,Italy,1,2,1,Netherlands,Italy,1897,1937,-40,40
1392,2012-02-28,Canada,5,Scotland,1,5,1,Canada,Scotland,1989,1770,219,-219
1393,2012-02-28,Korea Republic,2,South Africa,1,2,1,Korea Republic,South Africa,1845,1366,479,-479
1394,2012-02-28,New Zealand,2,Northern Ireland,0,2,0,New Zealand,Northern Ireland,1752,1437,315,-315
1395,2012-02-29,Germany,1,Iceland,0,1,0,Germany,Iceland,2143,1854,289,-289
1396,2012-02-29,Sweden,1,China PR,0,1,0,Sweden,China PR,2073,1831,242,-242
1397,2012-02-29,Japan,2,Norway,1,2,1,Japan,Norway,2106,1908,198,-198
1398,2012-02-29,USA,5,Denmark,0,5,0,USA,Denmark,2148,1908,240,-240
1399,2012-02-29,Republic of Ireland,0,Hungary,1,1,0,Hungary,Republic of Ireland,1610,1646,-36,36
1400,2012-02-29,Portugal,0,Wales,1,1,0,Wales,Portugal,1531,1555,-24,24
1401,2012-03-01,Switzerland,0,England,1,1,0,England,Switzerland,1983,1733,250,-250
1402,2012-03-01,Finland,1,France,2,2,1,France,Finland,1990,1802,188,-188
1403,2012-03-01,Scotland,2,Netherlands,1,2,1,Scotland,Netherlands,1770,1897,-127,127
1404,2012-03-01,Italy,1,Canada,2,2,1,Canada,Italy,1989,1937,52,-52
1405,2012-03-01,Northern Ireland,0,Korea Republic,1,1,0,Korea Republic,Northern Ireland,1845,1437,408,-408
1406,2012-03-01,South Africa,0,New Zealand,0,0,0,South Africa,New Zealand,1366,1752,-386,386
1407,2012-03-02,Iceland,1,Sweden,4,4,1,Sweden,Iceland,2073,1854,219,-219
1408,2012-03-02,Germany,1,China PR,0,1,0,Germany,China PR,2143,1831,312,-312
1409,2012-03-02,Denmark,0,Japan,2,2,0,Japan,Denmark,2106,1908,198,-198
1410,2012-03-02,USA,2,Norway,1,2,1,USA,Norway,2148,1908,240,-240
1411,2012-03-02,Portugal,4,Hungary,0,4,0,Portugal,Hungary,1555,1610,-55,55
1412,2012-03-02,Wales,0,Republic of Ireland,0,0,0,Wales,Republic of Ireland,1531,1646,-115,115
1413,2012-03-04,England,0,France,3,3,0,France,England,1990,1983,7,-7
1414,2012-03-04,Finland,3,Switzerland,1,3,1,Finland,Switzerland,1802,1733,69,-69
1415,2012-03-04,Italy,2,Scotland,1,2,1,Italy,Scotland,1937,1770,167,-167
1416,2012-03-04,Netherlands,0,Canada,1,1,0,Canada,Netherlands,1989,1897,92,-92
1417,2012-03-04,New Zealand,1,Korea Republic,1,1,1,New Zealand,Korea Republic,1752,1845,-93,93
1418,2012-03-04,Northern Ireland,0,South Africa,2,2,0,South Africa,Northern Ireland,1366,1437,-71,71
1419,2012-03-05,Sweden,0,Germany,4,4,0,Germany,Sweden,2143,2073,70,-70
1420,2012-03-05,China PR,0,Iceland,1,1,0,Iceland,China PR,1854,1831,23,-23
1421,2012-03-05,Norway,0,Denmark,1,1,0,Denmark,Norway,1908,1908,0,0
1422,2012-03-05,Japan,1,USA,0,1,0,Japan,USA,2106,2148,-42,42
1423,2012-03-05,Hungary,1,Wales,2,2,1,Wales,Hungary,1531,1610,-79,79
1424,2012-03-05,Portugal,2,Republic of Ireland,1,2,1,Portugal,Republic of Ireland,1555,1646,-91,91
1425,2012-03-06,Switzerland,5,Northern Ireland,0,5,0,Switzerland,Northern Ireland,1733,1437,296,-296
1426,2012-03-06,Scotland,2,South Africa,0,2,0,Scotland,South Africa,1770,1366,404,-404
1427,2012-03-06,New Zealand,2,Netherlands,2,2,2,New Zealand,Netherlands,1752,1897,-145,145
1428,2012-03-06,Korea Republic,1,Finland,1,1,1,Korea Republic,Finland,1845,1802,43,-43
1429,2012-03-06,England,1,Italy,3,3,1,Italy,England,1937,1983,-46,46
1430,2012-03-06,France,2,Canada,0,2,0,France,Canada,1990,1989,1,-1
1431,2012-03-07,Hungary,1,Republic of Ireland,2,2,1,Republic of Ireland,Hungary,1646,1610,36,-36
1432,2012-03-07,Portugal,0,China PR,1,1,0,China PR,Portugal,1831,1555,276,-276
1433,2012-03-07,Wales,0,Norway,3,3,0,Norway,Wales,1908,1531,377,-377
1434,2012-03-07,Iceland,1,Denmark,3,3,1,Denmark,Iceland,1908,1854,54,-54
1435,2012-03-07,Sweden,0,USA,4,4,0,USA,Sweden,2148,2073,75,-75
1436,2012-03-07,Germany,4,Japan,3,4,3,Germany,Japan,2143,2106,37,-37
1437,2012-03-31,Russia,8,FYR Macedonia,0,8,0,Russia,FYR Macedonia,1820,1066,754,-754
1438,2012-03-31,Greece,1,Poland,1,1,1,Greece,Poland,1393,1634,-241,241
1439,2012-03-31,Italy,4,Bosnia and Herzegovina,0,4,0,Italy,Bosnia and Herzegovina,1936,1267,669,-669
1440,2012-03-31,Romania,3,Kazakhstan,0,3,0,Romania,Kazakhstan,1585,1332,253,-253
1441,2012-03-31,Germany,5,Spain,0,5,0,Germany,Spain,2163,1842,321,-321
1442,2012-03-31,Switzerland,5,Turkey,0,5,0,Switzerland,Turkey,1727,1356,371,-371
1443,2012-03-31,Bulgaria,0,Norway,3,3,0,Norway,Bulgaria,1899,1434,465,-465
1444,2012-03-31,France,2,Scotland,0,2,0,France,Scotland,2020,1775,245,-245
1445,2012-03-31,Slovakia,0,Finland,1,1,0,Finland,Slovakia,1795,1581,214,-214
1446,2012-03-31,Croatia,0,England,6,6,0,England,Croatia,1965,1376,589,-589
1447,2012-03-31,Portugal,2,Czech Republic,5,5,2,Czech Republic,Portugal,1730,1557,173,-173
1448,2012-04-01,Japan,1,USA,1,1,1,Japan,USA,2114,2166,-52,52
1449,2012-04-01,Armenia,2,Austria,4,4,2,Austria,Armenia,1576,1103,473,-473
1450,2012-04-03,Brazil,0,USA,3,3,0,USA,Brazil,2166,2093,73,-73
1451,2012-04-04,Russia,0,Italy,2,2,0,Italy,Russia,1936,1820,116,-116
1452,2012-04-04,Greece,2,FYR Macedonia,2,2,2,Greece,FYR Macedonia,1393,1066,327,-327
1453,2012-04-04,Hungary,0,Norway,5,5,0,Norway,Hungary,1899,1599,300,-300
1454,2012-04-04,Belgium,1,Iceland,0,1,0,Belgium,Iceland,1629,1851,-222,222
1455,2012-04-04,France,4,Wales,0,4,0,France,Wales,2020,1546,474,-474
1456,2012-04-04,Czech Republic,0,Denmark,2,2,0,Denmark,Czech Republic,1913,1730,183,-183
1457,2012-04-05,Spain,13,Kazakhstan,0,13,0,Spain,Kazakhstan,1842,1332,510,-510
1458,2012-04-05,Switzerland,0,Germany,6,6,0,Germany,Switzerland,2163,1727,436,-436
1459,2012-04-05,Scotland,2,Republic of Ireland,1,2,1,Scotland,Republic of Ireland,1775,1637,138,-138
1460,2012-04-05,Finland,2,Slovakia,0,2,0,Finland,Slovakia,1795,1581,214,-214
1461,2012-04-05,Ukraine,5,Estonia,0,5,0,Ukraine,Estonia,1767,1328,439,-439
1462,2012-04-05,Netherlands,3,Slovenia,1,3,1,Netherlands,Slovenia,1889,1386,503,-503
1463,2012-04-05,Austria,1,Portugal,0,1,0,Austria,Portugal,1576,1557,19,-19
1464,2012-04-25,Northern Ireland,0,Hungary,1,1,0,Hungary,Northern Ireland,1599,1435,164,-164
1465,2012-05-19,Northern Ireland,4,Bulgaria,1,4,1,Northern Ireland,Bulgaria,1435,1434,1,-1
1466,2012-05-26,Côte d'Ivoire,7,Mozambique,0,7,0,Côte d'Ivoire,Mozambique,1341,875,466,-466
1467,2012-05-26,Zambia,1,South Africa,4,4,1,South Africa,Zambia,1372,945,427,-427
1468,2012-05-26,Morocco,0,Senegal,0,0,0,Morocco,Senegal,1338,1290,48,-48
1469,2012-05-26,Ghana,1,Cameroon,1,1,1,Ghana,Cameroon,1468,1466,2,-2
1470,2012-05-27,Ethiopia,2,Tanzania,1,2,1,Ethiopia,Tanzania,1151,949,202,-202
1471,2012-05-27,Zimbabwe,0,Nigeria,2,2,0,Nigeria,Zimbabwe,1686,1183,503,-503
1472,2012-05-28,USA,4,China PR,1,4,1,USA,China PR,2166,1828,338,-338
1473,2012-05-31,Germany,5,Romania,0,5,0,Germany,Romania,2163,1585,578,-578
1474,2012-06-16,Sweden,1,USA,3,3,1,USA,Sweden,2178,2066,112,-112
1475,2012-06-16,Tanzania,0,Ethiopia,1,1,0,Ethiopia,Tanzania,1151,944,207,-207
1476,2012-06-16,Mozambique,0,Côte d'Ivoire,5,5,0,Côte d'Ivoire,Mozambique,1342,874,468,-468
1477,2012-06-16,South Africa,2,Zambia,1,2,1,South Africa,Zambia,1377,942,435,-435
1478,2012-06-16,Senegal,0,Morocco,0,0,0,Senegal,Morocco,1295,1331,-36,36
1479,2012-06-16,Nigeria,4,Zimbabwe,0,4,0,Nigeria,Zimbabwe,1686,1187,499,-499
1480,2012-06-16,Italy,9,FYR Macedonia,0,9,0,Italy,FYR Macedonia,1947,1079,868,-868
1481,2012-06-16,Russia,4,Greece,0,4,0,Russia,Greece,1803,1386,417,-417
1482,2012-06-16,Bosnia and Herzegovina,0,Poland,2,2,0,Poland,Bosnia and Herzegovina,1623,1268,355,-355
1483,2012-06-16,Switzerland,4,Spain,3,4,3,Switzerland,Spain,1726,1841,-115,115
1484,2012-06-16,Norway,11,Bulgaria,0,11,0,Norway,Bulgaria,1908,1422,486,-486
1485,2012-06-16,Iceland,3,Hungary,0,3,0,Iceland,Hungary,1835,1595,240,-240
1486,2012-06-16,Scotland,8,Israel,0,8,0,Scotland,Israel,1777,1380,397,-397
1487,2012-06-16,Republic of Ireland,0,Wales,1,1,0,Wales,Republic of Ireland,1546,1634,-88,88
1488,2012-06-16,Estonia,2,Belarus,4,4,2,Belarus,Estonia,1579,1327,252,-252
1489,2012-06-16,Ukraine,1,Finland,2,2,1,Finland,Ukraine,1803,1773,30,-30
1490,2012-06-16,Croatia,1,Serbia,4,4,1,Serbia,Croatia,1543,1375,168,-168
1491,2012-06-16,Czech Republic,2,Austria,3,3,2,Austria,Czech Republic,1586,1731,-145,145
1492,2012-06-17,Cameroon,1,Ghana,1,1,1,Cameroon,Ghana,1470,1462,8,-8
1493,2012-06-17,England,1,Netherlands,0,1,0,England,Netherlands,1966,1887,79,-79
1494,2012-06-18,Japan,1,USA,4,4,1,USA,Japan,2178,2120,58,-58
1495,2012-06-20,Poland,4,FYR Macedonia,0,4,0,Poland,FYR Macedonia,1623,1079,544,-544
1496,2012-06-20,Hungary,1,Belgium,3,3,1,Belgium,Hungary,1644,1595,49,-49
1497,2012-06-20,Norway,2,Northern Ireland,0,2,0,Norway,Northern Ireland,1908,1437,471,-471
1498,2012-06-20,Wales,5,Israel,0,5,0,Wales,Israel,1546,1380,166,-166
1499,2012-06-20,Finland,4,Belarus,0,4,0,Finland,Belarus,1803,1579,224,-224
1500,2012-06-20,Slovakia,0,Ukraine,2,2,0,Ukraine,Slovakia,1773,1574,199,-199
1501,2012-06-20,Serbia,0,Netherlands,4,4,0,Netherlands,Serbia,1887,1543,344,-344
1502,2012-06-20,Denmark,1,Czech Republic,0,1,0,Denmark,Czech Republic,1923,1731,192,-192
1503,2012-06-21,Bosnia and Herzegovina,0,Russia,1,1,0,Russia,Bosnia and Herzegovina,1803,1268,535,-535
1504,2012-06-21,Spain,4,Turkey,0,4,0,Spain,Turkey,1841,1355,486,-486
1505,2012-06-21,Romania,4,Switzerland,2,4,2,Romania,Switzerland,1587,1726,-139,139
1506,2012-06-21,Bulgaria,0,Iceland,10,10,0,Iceland,Bulgaria,1835,1422,413,-413
1507,2012-06-21,Republic of Ireland,0,Scotland,1,1,0,Scotland,Republic of Ireland,1777,1634,143,-143
1508,2012-06-21,Slovenia,0,England,4,4,0,England,Slovenia,1966,1388,578,-578
1509,2012-06-30,USA,2,Canada,1,2,1,USA,Canada,2178,1981,197,-197
1510,2012-07-20,Equatorial Guinea,2,Cameroon,0,2,0,Equatorial Guinea,Cameroon,1371,1470,-99,99
1511,2012-07-25,Cameroon,0,Brazil,5,5,0,Brazil,Cameroon,2060,1470,590,-590
1512,2012-07-25,Japan,2,Canada,1,2,1,Japan,Canada,2120,1981,139,-139
1513,2012-07-25,Sweden,4,South Africa,1,4,1,Sweden,South Africa,2066,1377,689,-689
1514,2012-07-25,USA,4,France,2,4,2,USA,France,2178,2021,157,-157
1515,2012-07-25,Colombia,0,Korea DPR,2,2,0,Korea DPR,Colombia,1970,1651,319,-319
1516,2012-07-28,New Zealand,0,Brazil,1,1,0,Brazil,New Zealand,2060,1772,288,-288
1517,2012-07-28,Japan,0,Sweden,0,0,0,Japan,Sweden,2120,2066,54,-54
1518,2012-07-28,Canada,3,South Africa,0,3,0,Canada,South Africa,1981,1377,604,-604
1519,2012-07-28,USA,3,Colombia,0,3,0,USA,Colombia,2178,1651,527,-527
1520,2012-07-28,France,5,Korea DPR,0,5,0,France,Korea DPR,2021,1970,51,-51
1521,2012-07-31,New Zealand,3,Cameroon,1,3,1,New Zealand,Cameroon,1772,1470,302,-302
1522,2012-07-31,Japan,0,South Africa,0,0,0,Japan,South Africa,2120,1377,743,-743
1523,2012-07-31,Canada,2,Sweden,2,2,2,Canada,Sweden,1981,2066,-85,85
1524,2012-07-31,USA,1,Korea DPR,0,1,0,USA,Korea DPR,2178,1970,208,-208
1525,2012-07-31,France,1,Colombia,0,1,0,France,Colombia,2021,1651,370,-370
1526,2012-08-03,Sweden,1,France,2,2,1,France,Sweden,2021,2066,-45,45
1527,2012-08-03,USA,2,New Zealand,0,2,0,USA,New Zealand,2178,1772,406,-406
1528,2012-08-03,Brazil,0,Japan,2,2,0,Japan,Brazil,2120,2060,60,-60
1529,2012-08-06,France,1,Japan,2,2,1,Japan,France,2120,2021,99,-99
1530,2012-08-06,Canada,3,USA,4,4,3,USA,Canada,2178,1981,197,-197
1531,2012-08-09,Canada,1,France,0,1,0,Canada,France,1981,2021,-40,40
1532,2012-08-09,USA,2,Japan,1,2,1,USA,Japan,2178,2120,58,-58
1533,2012-08-25,Estonia,0,Slovakia,2,2,0,Slovakia,Estonia,1564,1328,236,-236
1534,2012-09-02,USA,8,Costa Rica,0,8,0,USA,Costa Rica,2221,1568,653,-653
1535,2012-09-15,FYR Macedonia,0,Russia,6,6,0,Russia,FYR Macedonia,1801,1079,722,-722
1536,2012-09-15,Bosnia and Herzegovina,1,Greece,1,1,1,Bosnia and Herzegovina,Greece,1267,1385,-118,118
1537,2012-09-15,Kazakhstan,0,Germany,7,7,0,Germany,Kazakhstan,2168,1329,839,-839
1538,2012-09-15,Turkey,1,Switzerland,3,3,1,Switzerland,Turkey,1722,1355,367,-367
1539,2012-09-15,Norway,3,Belgium,2,3,2,Norway,Belgium,1907,1650,257,-257
1540,2012-09-15,Iceland,2,Northern Ireland,0,2,0,Iceland,Northern Ireland,1842,1433,409,-409
1541,2012-09-15,Wales,1,Scotland,2,2,1,Scotland,Wales,1785,1581,204,-204
1542,2012-09-15,France,4,Republic of Ireland,0,4,0,France,Republic of Ireland,2021,1608,413,-413
1543,2012-09-15,Estonia,0,Finland,5,5,0,Finland,Estonia,1819,1328,491,-491
1544,2012-09-15,Belarus,0,Ukraine,5,5,0,Ukraine,Belarus,1769,1581,188,-188
1545,2012-09-15,Slovenia,1,Croatia,0,1,0,Slovenia,Croatia,1387,1364,23,-23
1546,2012-09-15,Austria,3,Denmark,1,3,1,Austria,Denmark,1605,1923,-318,318
1547,2012-09-16,Italy,1,Poland,0,1,0,Italy,Poland,1947,1626,321,-321
1548,2012-09-17,USA,2,Australia,1,2,1,USA,Australia,2221,1948,273,-273
1549,2012-09-19,Greece,0,Italy,0,0,0,Greece,Italy,1385,1947,-562,562
1550,2012-09-19,Bosnia and Herzegovina,1,FYR Macedonia,0,1,0,Bosnia and Herzegovina,FYR Macedonia,1267,1079,188,-188
1551,2012-09-19,Russia,1,Poland,1,1,1,Russia,Poland,1801,1626,175,-175
1552,2012-09-19,Kazakhstan,1,Switzerland,0,1,0,Kazakhstan,Switzerland,1329,1722,-393,393
1553,2012-09-19,Germany,10,Turkey,0,10,0,Germany,Turkey,2168,1355,813,-813
1554,2012-09-19,Spain,0,Romania,0,0,0,Spain,Romania,1831,1598,233,-233
1555,2012-09-19,Hungary,9,Bulgaria,0,9,0,Hungary,Bulgaria,1578,1417,161,-161
1556,2012-09-19,Northern Ireland,0,Belgium,2,2,0,Belgium,Northern Ireland,1650,1433,217,-217
1557,2012-09-19,Norway,2,Iceland,1,2,1,Norway,Iceland,1907,1842,65,-65
1558,2012-09-19,Israel,0,Republic of Ireland,2,2,0,Republic of Ireland,Israel,1608,1374,234,-234
1559,2012-09-19,Scotland,0,France,5,5,0,France,Scotland,2021,1785,236,-236
1560,2012-09-19,Belarus,1,Slovakia,0,1,0,Belarus,Slovakia,1581,1564,17,-17
1561,2012-09-19,Finland,0,Ukraine,1,1,0,Ukraine,Finland,1769,1819,-50,50
1562,2012-09-19,Serbia,3,Slovenia,0,3,0,Serbia,Slovenia,1548,1387,161,-161
1563,2012-09-19,England,3,Croatia,0,3,0,England,Croatia,1970,1364,606,-606
1564,2012-09-19,Armenia,0,Czech Republic,2,2,0,Czech Republic,Armenia,1712,1103,609,-609
1565,2012-09-19,Denmark,2,Portugal,0,2,0,Denmark,Portugal,1923,1542,381,-381
1566,2012-09-20,USA,6,Australia,2,6,2,USA,Australia,2221,1948,273,-273
1567,2012-10-20,Scotland,1,Spain,1,1,1,Scotland,Spain,1785,1831,-46,46
1568,2012-10-20,Ukraine,2,Iceland,3,3,2,Iceland,Ukraine,1842,1769,73,-73
1569,2012-10-21,USA,1,Germany,1,1,1,USA,Germany,2221,2168,53,-53
1570,2012-10-21,Austria,0,Russia,2,2,0,Russia,Austria,1801,1605,196,-196
1571,2012-10-24,USA,2,Germany,2,2,2,USA,Germany,2221,2168,53,-53
1572,2012-10-24,Spain,3,Scotland,2,3,2,Spain,Scotland,1831,1785,46,-46
1573,2012-10-25,Russia,1,Austria,1,1,1,Russia,Austria,1801,1605,196,-196
1574,2012-10-25,Iceland,3,Ukraine,2,3,2,Iceland,Ukraine,1842,1769,73,-73
1575,2012-10-28,Equatorial Guinea,1,South Africa,0,1,0,Equatorial Guinea,South Africa,1371,1412,-41,41
1576,2012-10-28,Senegal,0,Congo DR,1,1,0,Congo DR,Senegal,1113,1295,-182,182
1577,2012-10-29,Nigeria,2,Cameroon,1,2,1,Nigeria,Cameroon,1675,1470,205,-205
1578,2012-10-29,Côte d'Ivoire,5,Ethiopia,0,5,0,Côte d'Ivoire,Ethiopia,1343,1158,185,-185
1579,2012-10-31,South Africa,1,Senegal,0,1,0,South Africa,Senegal,1412,1295,117,-117
1580,2012-10-31,Equatorial Guinea,6,Congo DR,0,6,0,Equatorial Guinea,Congo DR,1371,1113,258,-258
1581,2012-11-01,Cameroon,4,Côte d'Ivoire,1,4,1,Cameroon,Côte d'Ivoire,1470,1343,127,-127
1582,2012-11-01,Ethiopia,0,Nigeria,3,3,0,Nigeria,Ethiopia,1675,1158,517,-517
1583,2012-11-03,Equatorial Guinea,5,Senegal,0,5,0,Equatorial Guinea,Senegal,1371,1295,76,-76
1584,2012-11-03,South Africa,4,Congo DR,1,4,1,South Africa,Congo DR,1412,1113,299,-299
1585,2012-11-04,Nigeria,3,Côte d'Ivoire,1,3,1,Nigeria,Côte d'Ivoire,1675,1343,332,-332
1586,2012-11-04,Cameroon,0,Ethiopia,0,0,0,Cameroon,Ethiopia,1470,1158,312,-312
1587,2012-11-07,Nigeria,0,South Africa,1,1,0,South Africa,Nigeria,1412,1675,-263,263
1588,2012-11-11,Cameroon,1,Nigeria,0,1,0,Cameroon,Nigeria,1470,1675,-205,205
1589,2012-11-11,Equatorial Guinea,4,South Africa,0,4,0,Equatorial Guinea,South Africa,1371,1412,-41,41
1590,2012-11-29,USA,5,Republic of Ireland,0,5,0,USA,Republic of Ireland,2221,1608,613,-613
1591,2012-12-02,USA,2,Republic of Ireland,0,2,0,USA,Republic of Ireland,2221,1608,613,-613
1592,2012-12-08,USA,2,China PR,0,2,0,USA,China PR,2209,1825,384,-384
1593,2012-12-13,USA,4,China PR,0,4,0,USA,China PR,2209,1825,384,-384
1594,2012-12-16,USA,4,China PR,1,4,1,USA,China PR,2209,1825,384,-384
1595,2013-01-12,Norway,2,Korea Republic,0,2,0,Norway,Korea Republic,1909,1843,66,-66
1596,2013-01-12,China PR,0,Canada,1,1,0,Canada,China PR,2006,1825,181,-181
1597,2013-01-14,China PR,0,Norway,1,1,0,Norway,China PR,1909,1825,84,-84
1598,2013-01-14,Canada,1,Korea Republic,3,3,1,Korea Republic,Canada,1843,2006,-163,163
1599,2013-01-16,China PR,2,Korea Republic,0,2,0,China PR,Korea Republic,1825,1843,-18,18
1600,2013-01-16,Canada,0,Norway,0,0,0,Canada,Norway,2006,1909,97,-97
1601,2013-02-10,USA,4,Scotland,1,4,1,USA,Scotland,2209,1779,430,-430
1602,2013-02-14,USA,3,Scotland,1,3,1,USA,Scotland,2209,1779,430,-430
1603,2013-03-06,Norway,2,Japan,0,2,0,Norway,Japan,1909,2110,-201,201
1604,2013-03-06,Denmark,0,Germany,0,0,0,Denmark,Germany,1902,2171,-269,269
1605,2013-03-06,USA,3,Iceland,0,3,0,USA,Iceland,2209,1853,356,-356
1606,2013-03-06,Sweden,1,China PR,1,1,1,Sweden,China PR,2021,1825,196,-196
1607,2013-03-06,Mexico,1,Hungary,0,1,0,Mexico,Hungary,1768,1589,179,-179
1608,2013-03-06,Portugal,2,Wales,0,2,0,Portugal,Wales,1542,1575,-33,33
1609,2013-03-06,New Zealand,1,Scotland,0,1,0,New Zealand,Scotland,1787,1779,8,-8
1610,2013-03-06,England,4,Italy,2,4,2,England,Italy,1976,1931,45,-45
1611,2013-03-06,Canada,2,Switzerland,0,2,0,Canada,Switzerland,2006,1708,298,-298
1612,2013-03-06,Finland,1,Netherlands,1,1,1,Finland,Netherlands,1805,1895,-90,90
1613,2013-03-06,Korea Republic,2,South Africa,0,2,0,Korea Republic,South Africa,1843,1425,418,-418
1614,2013-03-06,Republic of Ireland,5,Northern Ireland,1,5,1,Republic of Ireland,Northern Ireland,1615,1426,189,-189
1615,2013-03-08,Germany,2,Japan,1,2,1,Germany,Japan,2171,2110,61,-61
1616,2013-03-08,Norway,0,Denmark,0,0,0,Norway,Denmark,1909,1902,7,-7
1617,2013-03-08,USA,5,China PR,0,5,0,USA,China PR,2209,1825,384,-384
1618,2013-03-08,Sweden,6,Iceland,1,6,1,Sweden,Iceland,2021,1853,168,-168
1619,2013-03-08,Portugal,0,Hungary,2,2,0,Hungary,Portugal,1589,1542,47,-47
1620,2013-03-08,Wales,1,Mexico,0,1,0,Wales,Mexico,1575,1768,-193,193
1621,2013-03-08,New Zealand,2,Italy,0,2,0,New Zealand,Italy,1787,1931,-144,144
1622,2013-03-08,Scotland,4,England,4,4,4,Scotland,England,1779,1976,-197,197
1623,2013-03-08,Switzerland,1,Netherlands,1,1,1,Switzerland,Netherlands,1708,1895,-187,187
1624,2013-03-08,Finland,1,Canada,2,2,1,Canada,Finland,2006,1805,201,-201
1625,2013-03-08,Republic of Ireland,1,South Africa,0,1,0,Republic of Ireland,South Africa,1615,1425,190,-190
1626,2013-03-08,Korea Republic,3,Northern Ireland,0,3,0,Korea Republic,Northern Ireland,1843,1426,417,-417
1627,2013-03-11,Denmark,0,Japan,2,2,0,Japan,Denmark,2110,1902,208,-208
1628,2013-03-11,Germany,2,Norway,0,2,0,Germany,Norway,2171,1909,262,-262
1629,2013-03-11,China PR,1,Iceland,0,1,0,China PR,Iceland,1825,1853,-28,28
1630,2013-03-11,Sweden,1,USA,1,1,1,Sweden,USA,2021,2209,-188,188
1631,2013-03-11,Wales,1,Hungary,1,1,1,Wales,Hungary,1575,1589,-14,14
1632,2013-03-11,Portugal,0,Mexico,3,3,0,Mexico,Portugal,1768,1542,226,-226
1633,2013-03-11,England,3,New Zealand,1,3,1,England,New Zealand,1976,1787,189,-189
1634,2013-03-11,Italy,1,Scotland,2,2,1,Scotland,Italy,1779,1931,-152,152
1635,2013-03-11,Finland,2,Switzerland,3,3,2,Switzerland,Finland,1708,1805,-97,97
1636,2013-03-11,Netherlands,0,Canada,1,1,0,Canada,Netherlands,2006,1895,111,-111
1637,2013-03-11,South Africa,2,Northern Ireland,1,2,1,South Africa,Northern Ireland,1425,1426,-1,1
1638,2013-03-11,Korea Republic,0,Republic of Ireland,0,0,0,Korea Republic,Republic of Ireland,1843,1615,228,-228
1639,2013-03-13,Portugal,1,Wales,1,1,1,Portugal,Wales,1542,1575,-33,33
1640,2013-03-13,Hungary,1,Iceland,4,4,1,Iceland,Hungary,1853,1589,264,-264
1641,2013-03-13,Mexico,0,Denmark,3,3,0,Denmark,Mexico,1902,1768,134,-134
1642,2013-03-13,Japan,1,China PR,0,1,0,Japan,China PR,2110,1825,285,-285
1643,2013-03-13,Norway,2,Sweden,2,2,2,Norway,Sweden,1909,2021,-112,112
1644,2013-03-13,Germany,0,USA,2,2,0,USA,Germany,2209,2171,38,-38
1645,2013-03-13,South Africa,1,Northern Ireland,1,1,1,South Africa,Northern Ireland,1425,1426,-1,1
1646,2013-03-13,Korea Republic,0,Italy,1,1,0,Italy,Korea Republic,1931,1843,88,-88
1647,2013-03-13,Republic of Ireland,0,Finland,1,1,0,Finland,Republic of Ireland,1805,1615,190,-190
1648,2013-03-13,Scotland,1,Netherlands,0,1,0,Scotland,Netherlands,1779,1895,-116,116
1649,2013-03-13,New Zealand,2,Switzerland,1,2,1,New Zealand,Switzerland,1787,1708,79,-79
1650,2013-03-13,England,1,Canada,0,1,0,England,Canada,1976,2006,-30,30
1651,2013-04-05,Germany,3,USA,3,3,3,Germany,USA,2163,2215,-52,52
1652,2013-04-09,Netherlands,1,USA,3,3,1,USA,Netherlands,2215,1881,334,-334
1653,2013-05-21,IR Iran,0,Philippines,6,6,0,Philippines,IR Iran,1268,1437,-169,169
1654,2013-05-21,Bangladesh,0,Thailand,9,9,0,Thailand,Bangladesh,1641,988,653,-653
1655,2013-05-21,Palestine,0,Chinese Taipei,6,6,0,Chinese Taipei,Palestine,1555,1189,366,-366
1656,2013-05-21,Myanmar,2,India,0,2,0,Myanmar,India,1536,1441,95,-95
1657,2013-05-22,Bahrain,0,Vietnam,8,8,0,Vietnam,Bahrain,1640,1340,300,-300
1658,2013-05-22,Hong Kong,2,Kyrgyz Republic,1,2,1,Hong Kong,Kyrgyz Republic,1347,1143,204,-204
1659,2013-05-23,Philippines,0,Thailand,1,1,0,Thailand,Philippines,1641,1268,373,-373
1660,2013-05-23,Bangladesh,0,IR Iran,2,2,0,IR Iran,Bangladesh,1437,988,449,-449
1661,2013-05-23,Palestine,0,Myanmar,9,9,0,Myanmar,Palestine,1536,1189,347,-347
1662,2013-05-23,India,1,Chinese Taipei,2,2,1,Chinese Taipei,India,1555,1441,114,-114
1663,2013-05-24,Bahrain,1,Hong Kong,3,3,1,Hong Kong,Bahrain,1347,1340,7,-7
1664,2013-05-24,Kyrgyz Republic,0,Vietnam,12,12,0,Vietnam,Kyrgyz Republic,1640,1143,497,-497
1665,2013-05-25,Thailand,5,IR Iran,1,5,1,Thailand,IR Iran,1641,1437,204,-204
1666,2013-05-25,Bangladesh,0,Philippines,4,4,0,Philippines,Bangladesh,1268,988,280,-280
1667,2013-05-25,Palestine,1,India,1,1,1,Palestine,India,1189,1441,-252,252
1668,2013-05-25,Myanmar,0,Chinese Taipei,0,0,0,Myanmar,Chinese Taipei,1536,1555,-19,19
1669,2013-05-26,Vietnam,4,Hong Kong,0,4,0,Vietnam,Hong Kong,1640,1347,293,-293
1670,2013-05-26,Bahrain,4,Kyrgyz Republic,1,4,1,Bahrain,Kyrgyz Republic,1340,1143,197,-197
1671,2013-06-03,Canada,0,USA,3,3,0,USA,Canada,2215,1992,223,-223
1672,2013-06-05,Uzbekistan,18,Kuwait,0,18,0,Uzbekistan,Kuwait,1565,768,797,-797
1673,2013-06-05,Jordan,5,Lebanon,0,5,0,Jordan,Lebanon,1398,944,454,-454
1674,2013-06-07,Lebanon,0,Uzbekistan,4,4,0,Uzbekistan,Lebanon,1565,944,621,-621
1675,2013-06-07,Jordan,21,Kuwait,0,21,0,Jordan,Kuwait,1398,768,630,-630
1676,2013-06-09,Lebanon,12,Kuwait,1,12,1,Lebanon,Kuwait,944,768,176,-176
1677,2013-06-09,Jordan,4,Uzbekistan,0,4,0,Jordan,Uzbekistan,1398,1565,-167,167
1678,2013-06-16,USA,4,Korea Republic,1,4,1,USA,Korea Republic,2215,1835,380,-380
1679,2013-06-21,USA,5,Korea Republic,0,5,0,USA,Korea Republic,2215,1835,380,-380
1679,2013-06-21,USA,5,Korea Republic,0,5,0,USA,Korea Republic,2215,1835,380,-380
1679,2013-06-21,USA,5,Korea Republic,0,5,0,USA,Korea Republic,2228,1835,393,-393
1679,2013-06-21,USA,5,Korea Republic,0,5,0,USA,Korea Republic,2228,1835,393,-393
1680,2013-07-10,Italy,0,Finland,0,0,0,Italy,Finland,1915,1791,124,-124
1681,2013-07-10,Sweden,1,Denmark,1,1,1,Sweden,Denmark,2027,1905,122,-122
1682,2013-07-11,Norway,1,Iceland,1,1,1,Norway,Iceland,1922,1836,86,-86
1683,2013-07-11,Germany,0,Netherlands,0,0,0,Germany,Netherlands,2162,1887,275,-275
1684,2013-07-12,France,3,Russia,1,3,1,France,Russia,2023,1780,243,-243
1685,2013-07-12,England,2,Spain,3,3,2,Spain,England,1824,1999,-175,175
1686,2013-07-13,Italy,2,Denmark,1,2,1,Italy,Denmark,1915,1905,10,-10
1687,2013-07-13,Sweden,5,Finland,0,5,0,Sweden,Finland,2027,1791,236,-236
1688,2013-07-14,Norway,1,Netherlands,0,1,0,Norway,Netherlands,1922,1887,35,-35
1689,2013-07-14,Iceland,0,Germany,3,3,0,Germany,Iceland,2162,1836,326,-326
1690,2013-07-15,England,1,Russia,1,1,1,England,Russia,1999,1780,219,-219
1691,2013-07-15,Spain,0,France,1,1,0,France,Spain,2023,1824,199,-199
1692,2013-07-16,Sweden,3,Italy,1,3,1,Sweden,Italy,2027,1915,112,-112
1693,2013-07-16,Denmark,1,Finland,1,1,1,Denmark,Finland,1905,1791,114,-114
1694,2013-07-17,Germany,0,Norway,1,1,0,Norway,Germany,1922,2162,-240,240
1695,2013-07-17,Netherlands,0,Iceland,1,1,0,Iceland,Netherlands,1836,1887,-51,51
1696,2013-07-18,France,3,England,0,3,0,France,England,2023,1999,24,-24
1697,2013-07-18,Russia,1,Spain,1,1,1,Russia,Spain,1780,1824,-44,44
1698,2013-07-21,Sweden,4,Iceland,0,4,0,Sweden,Iceland,2027,1836,191,-191
1699,2013-07-21,Italy,0,Germany,1,1,0,Germany,Italy,2162,1915,247,-247
1700,2013-07-22,Norway,3,Spain,1,3,1,Norway,Spain,1922,1824,98,-98
1701,2013-07-22,France,1,Denmark,1,1,1,France,Denmark,2023,1905,118,-118
1702,2013-07-24,Sweden,0,Germany,1,1,0,Germany,Sweden,2162,2027,135,-135
1703,2013-07-25,Norway,1,Denmark,1,1,1,Norway,Denmark,1922,1905,17,-17
1704,2013-07-28,Germany,1,Norway,0,1,0,Germany,Norway,2162,1922,240,-240
1705,2013-09-04,USA,7,Mexico,0,7,0,USA,Mexico,2229,1761,468,-468
1706,2013-10-20,USA,4,Australia,0,4,0,USA,Australia,2229,1956,273,-273
1707,2013-10-28,USA,4,New Zealand,1,4,1,USA,New Zealand,2229,1810,419,-419
1708,2013-10-31,USA,1,New Zealand,1,1,1,USA,New Zealand,2229,1810,419,-419
1709,2013-11-11,USA,4,Brazil,1,4,1,USA,Brazil,2229,2042,187,-187
1710,2014-01-31,USA,1,Canada,0,1,0,USA,Canada,2228,1978,250,-250
1711,2014-02-09,USA,7,Russia,0,7,0,USA,Russia,2228,1806,422,-422
1712,2014-02-11,China PR,1,New Zealand,0,1,0,China PR,New Zealand,1826,1834,-8,8
1713,2014-02-11,Korea DPR,2,Mexico,0,2,0,Korea DPR,Mexico,1956,1760,196,-196
1714,2014-02-13,China PR,3,Mexico,1,3,1,China PR,Mexico,1826,1760,66,-66
1715,2014-02-13,Korea DPR,1,New Zealand,0,1,0,Korea DPR,New Zealand,1956,1834,122,-122
1716,2014-02-14,USA,8,Russia,0,8,0,USA,Russia,2228,1806,422,-422
1717,2014-02-14,Algeria,2,Morocco,0,2,0,Algeria,Morocco,1320,1330,-10,10
1718,2014-02-14,Botswana,0,Zimbabwe,1,1,0,Zimbabwe,Botswana,1224,708,516,-516
1719,2014-02-14,Zambia,2,Tanzania,1,2,1,Zambia,Tanzania,938,941,-3,3
1720,2014-02-15,Côte d'Ivoire,4,Mali,0,4,0,Côte d'Ivoire,Mali,1344,1204,140,-140
1721,2014-02-15,China PR,1,Korea DPR,0,1,0,China PR,Korea DPR,1826,1956,-130,130
1722,2014-02-15,New Zealand,1,Mexico,2,2,1,Mexico,New Zealand,1760,1834,-74,74
1723,2014-02-16,Egypt,0,Tunisia,3,3,0,Tunisia,Egypt,1325,1289,36,-36
1724,2014-02-16,Burkina Faso,0,Ghana,3,3,0,Ghana,Burkina Faso,1459,1038,421,-421
1725,2014-02-16,Rwanda,1,Kenya,0,1,0,Rwanda,Kenya,996,855,141,-141
1726,2014-02-28,Mali,0,Côte d'Ivoire,1,1,0,Côte d'Ivoire,Mali,1344,1204,140,-140
1727,2014-02-28,Tanzania,1,Zambia,1,1,1,Tanzania,Zambia,941,938,3,-3
1728,2014-03-01,Morocco,0,Algeria,0,0,0,Morocco,Algeria,1330,1320,10,-10
1729,2014-03-01,Tunisia,2,Egypt,2,2,2,Tunisia,Egypt,1325,1289,36,-36
1730,2014-03-01,Ghana,3,Burkina Faso,0,3,0,Ghana,Burkina Faso,1459,1038,421,-421
1731,2014-03-02,Kenya,2,Rwanda,1,2,1,Kenya,Rwanda,855,996,-141,141
1732,2014-03-02,Zimbabwe,2,Botswana,1,2,1,Zimbabwe,Botswana,1224,708,516,-516
1733,2014-03-05,Norway,0,China PR,1,1,0,China PR,Norway,1826,1973,-147,147
1734,2014-03-05,Germany,5,Iceland,0,5,0,Germany,Iceland,2156,1822,334,-334
1735,2014-03-05,Japan,1,USA,1,1,1,Japan,USA,2071,2228,-157,157
1736,2014-03-05,Sweden,2,Denmark,0,2,0,Sweden,Denmark,2021,1872,149,-149
1737,2014-03-05,Russia,1,Korea DPR,2,2,1,Korea DPR,Russia,1956,1806,150,-150
1738,2014-03-05,Portugal,3,Austria,2,3,2,Portugal,Austria,1550,1650,-100,100
1739,2014-03-05,Canada,3,Finland,0,3,0,Canada,Finland,1978,1786,192,-192
1740,2014-03-05,England,2,Italy,0,2,0,England,Italy,1942,1892,50,-50
1741,2014-03-05,Netherlands,2,Australia,2,2,2,Netherlands,Australia,1868,1957,-89,89
1742,2014-03-05,France,1,Scotland,1,1,1,France,Scotland,2027,1820,207,-207
1743,2014-03-05,New Zealand,1,Republic of Ireland,1,1,1,New Zealand,Republic of Ireland,1834,1633,201,-201
1744,2014-03-05,Switzerland,1,Korea Republic,1,1,1,Switzerland,Korea Republic,1794,1829,-35,35
1745,2014-03-07,Norway,1,Iceland,2,2,1,Iceland,Norway,1822,1973,-151,151
1746,2014-03-07,Germany,1,China PR,0,1,0,Germany,China PR,2156,1826,330,-330
1747,2014-03-07,Sweden,1,USA,0,1,0,Sweden,USA,2021,2228,-207,207
1748,2014-03-07,Japan,1,Denmark,0,1,0,Japan,Denmark,2071,1872,199,-199
1749,2014-03-07,Portugal,1,Russia,3,3,1,Russia,Portugal,1806,1550,256,-256
1750,2014-03-07,Austria,0,Korea DPR,2,2,0,Korea DPR,Austria,1956,1650,306,-306
1751,2014-03-07,Finland,0,England,3,3,0,England,Finland,1942,1786,156,-156
1752,2014-03-07,Canada,3,Italy,1,3,1,Canada,Italy,1978,1892,86,-86
1753,2014-03-07,Scotland,4,Netherlands,3,4,3,Scotland,Netherlands,1820,1868,-48,48
1754,2014-03-07,Australia,2,France,3,3,2,France,Australia,2027,1957,70,-70
1755,2014-03-07,Republic of Ireland,1,Korea Republic,1,1,1,Republic of Ireland,Korea Republic,1633,1829,-196,196
1756,2014-03-07,Switzerland,2,New Zealand,1,2,1,Switzerland,New Zealand,1794,1834,-40,40
1757,2014-03-10,China PR,0,Iceland,1,1,0,Iceland,China PR,1822,1826,-4,4
1758,2014-03-10,Norway,1,Germany,3,3,1,Germany,Norway,2156,1973,183,-183
1759,2014-03-10,Japan,2,Sweden,1,2,1,Japan,Sweden,2071,2021,50,-50
1760,2014-03-10,USA,3,Denmark,5,5,3,Denmark,USA,1872,2228,-356,356
1761,2014-03-10,Portugal,0,Korea DPR,2,2,0,Korea DPR,Portugal,1956,1550,406,-406
1762,2014-03-10,Austria,3,Russia,2,3,2,Austria,Russia,1650,1806,-156,156
1763,2014-03-10,England,2,Canada,0,2,0,England,Canada,1942,1978,-36,36
1764,2014-03-10,Italy,1,Finland,1,1,1,Italy,Finland,1892,1786,106,-106
1765,2014-03-10,Netherlands,0,France,3,3,0,France,Netherlands,2027,1868,159,-159
1766,2014-03-10,Australia,2,Scotland,4,4,2,Scotland,Australia,1820,1957,-137,137
1767,2014-03-10,Switzerland,1,Republic of Ireland,2,2,1,Republic of Ireland,Switzerland,1633,1794,-161,161
1768,2014-03-10,Korea Republic,4,New Zealand,0,4,0,Korea Republic,New Zealand,1829,1834,-5,5
1769,2014-03-12,Portugal,1,Austria,2,2,1,Austria,Portugal,1650,1550,100,-100
1770,2014-03-12,Russia,1,Norway,0,1,0,Russia,Norway,1806,1973,-167,167
1771,2014-03-12,Korea DPR,0,USA,3,3,0,USA,Korea DPR,2228,1956,272,-272
1772,2014-03-12,China PR,1,Denmark,1,1,1,China PR,Denmark,1826,1872,-46,46
1773,2014-03-12,Iceland,2,Sweden,1,2,1,Iceland,Sweden,1822,2021,-199,199
1774,2014-03-12,Germany,3,Japan,0,3,0,Germany,Japan,2156,2071,85,-85
1775,2014-03-12,Finland,0,New Zealand,1,1,0,New Zealand,Finland,1834,1786,48,-48
1776,2014-03-12,Netherlands,4,Switzerland,1,4,1,Netherlands,Switzerland,1868,1794,74,-74
1777,2014-03-12,Italy,2,Australia,5,5,2,Australia,Italy,1957,1892,65,-65
1778,2014-03-12,Canada,2,Republic of Ireland,1,2,1,Canada,Republic of Ireland,1978,1633,345,-345
1779,2014-03-12,Scotland,1,Korea Republic,1,1,1,Scotland,Korea Republic,1820,1829,-9,9
1780,2014-03-12,England,0,France,2,2,0,France,England,2027,1942,85,-85
1781,2014-04-07,USA,2,China PR,0,2,0,USA,China PR,2197,1843,354,-354
1782,2014-04-11,USA,3,China PR,0,3,0,USA,China PR,2197,1843,354,-354
1783,2014-05-09,Canada,1,USA,1,1,1,Canada,USA,1971,2197,-226,226
1784,2014-05-14,Vietnam,3,Jordan,1,3,1,Vietnam,Jordan,1664,1415,249,-249
1785,2014-05-14,Australia,2,Japan,2,2,2,Australia,Japan,1945,2076,-131,131
1786,2014-05-15,Korea Republic,12,Myanmar,0,12,0,Korea Republic,Myanmar,1833,1544,289,-289
1787,2014-05-15,China PR,7,Thailand,0,7,0,China PR,Thailand,1843,1649,194,-194
1788,2014-05-16,Jordan,1,Australia,3,3,1,Australia,Jordan,1945,1415,530,-530
1789,2014-05-16,Vietnam,0,Japan,4,4,0,Japan,Vietnam,2076,1664,412,-412
1790,2014-05-17,Myanmar,0,China PR,3,3,0,China PR,Myanmar,1843,1544,299,-299
1791,2014-05-17,Thailand,0,Korea Republic,4,4,0,Korea Republic,Thailand,1833,1649,184,-184
1792,2014-05-18,Vietnam,0,Australia,2,2,0,Australia,Vietnam,1945,1664,281,-281
1793,2014-05-18,Japan,7,Jordan,0,7,0,Japan,Jordan,2076,1415,661,-661
1794,2014-05-19,Korea Republic,0,China PR,0,0,0,Korea Republic,China PR,1833,1843,-10,10
1795,2014-05-19,Thailand,2,Myanmar,1,2,1,Thailand,Myanmar,1649,1544,105,-105
1796,2014-05-20,Honduras,8,Belize,0,8,0,Honduras,Belize,1153,827,326,-326
1797,2014-05-20,Guatemala,1,Panama,0,1,0,Guatemala,Panama,1318,1364,-46,46
1798,2014-05-20,Nicaragua,0,El Salvador,2,2,0,El Salvador,Nicaragua,1175,1111,64,-64
1799,2014-05-21,Vietnam,1,Thailand,2,2,1,Thailand,Vietnam,1649,1664,-15,15
1800,2014-05-22,Belize,1,Panama,13,13,1,Panama,Belize,1364,827,537,-537
1801,2014-05-22,Guatemala,3,Honduras,2,3,2,Guatemala,Honduras,1318,1153,165,-165
1802,2014-05-22,El Salvador,0,Costa Rica,4,4,0,Costa Rica,El Salvador,1561,1175,386,-386
1803,2014-05-22,Japan,2,China PR,1,2,1,Japan,China PR,2076,1843,233,-233
1804,2014-05-22,Korea Republic,1,Australia,2,2,1,Australia,Korea Republic,1945,1833,112,-112
1805,2014-05-23,Algeria,2,Tunisia,1,2,1,Algeria,Tunisia,1327,1335,-8,8
1806,2014-05-23,Côte d'Ivoire,1,Equatorial Guinea,1,1,1,Côte d'Ivoire,Equatorial Guinea,1357,1429,-72,72
1807,2014-05-23,Comoros,0,South Africa,13,13,0,South Africa,Comoros,1430,837,593,-593
1808,2014-05-24,Rwanda,1,Nigeria,4,4,1,Nigeria,Rwanda,1623,996,627,-627
1809,2014-05-24,Senegal,1,Cameroon,1,1,1,Senegal,Cameroon,1252,1467,-215,215
1810,2014-05-24,Panama,4,Honduras,1,4,1,Panama,Honduras,1364,1153,211,-211
1811,2014-05-24,Guatemala,5,Belize,0,5,0,Guatemala,Belize,1318,827,491,-491
1812,2014-05-24,Costa Rica,3,Nicaragua,0,3,0,Costa Rica,Nicaragua,1561,1111,450,-450
1813,2014-05-25,Ethiopia,0,Ghana,2,2,0,Ghana,Ethiopia,1459,1163,296,-296
1814,2014-05-25,Zimbabwe,0,Zambia,1,1,0,Zambia,Zimbabwe,948,1226,-278,278
1815,2014-05-25,China PR,2,Korea Republic,1,2,1,China PR,Korea Republic,1843,1833,10,-10
1816,2014-05-25,Japan,1,Australia,0,1,0,Japan,Australia,2076,1945,131,-131
1817,2014-05-26,Guatemala,0,Costa Rica,3,3,0,Costa Rica,Guatemala,1561,1318,243,-243
1818,2014-06-07,Equatorial Guinea,2,Côte d'Ivoire,2,2,2,Equatorial Guinea,Côte d'Ivoire,1429,1357,72,-72
1819,2014-06-07,Nigeria,8,Rwanda,0,8,0,Nigeria,Rwanda,1623,996,627,-627
1820,2014-06-08,Tunisia,2,Algeria,3,3,2,Algeria,Tunisia,1327,1335,-8,8
1821,2014-06-08,Ghana,3,Ethiopia,0,3,0,Ghana,Ethiopia,1459,1163,296,-296
1822,2014-06-08,Cameroon,1,Senegal,0,1,0,Cameroon,Senegal,1467,1252,215,-215
1823,2014-06-08,Zambia,1,Zimbabwe,0,1,0,Zambia,Zimbabwe,948,1226,-278,278
1824,2014-06-15,USA,1,France,0,1,0,USA,France,2197,2051,146,-146
1825,2014-06-19,USA,2,France,2,2,2,USA,France,2197,2051,146,-146
1826,2014-08-21,USA,4,Switzerland,1,4,1,USA,Switzerland,2193,1814,379,-379
1827,2014-09-14,USA,8,Mexico,0,8,0,USA,Mexico,2193,1761,432,-432
1828,2014-09-19,USA,4,Mexico,0,4,0,USA,Mexico,2193,1761,432,-432
1828,2014-09-19,USA,4,Mexico,0,4,0,USA,Mexico,2193,1760,433,-433
1828,2014-09-19,USA,4,Mexico,0,4,0,USA,Mexico,2185,1761,424,-424
1828,2014-09-19,USA,4,Mexico,0,4,0,USA,Mexico,2185,1760,425,-425
1829,2014-10-11,Namibia,2,Zambia,0,2,0,Namibia,Zambia,1021,986,35,-35
1830,2014-10-11,Nigeria,4,Côte d'Ivoire,2,4,2,Nigeria,Côte d'Ivoire,1623,1376,247,-247
1831,2014-10-12,South Africa,0,Cameroon,1,1,0,Cameroon,South Africa,1457,1423,34,-34
1832,2014-10-12,Algeria,1,Ghana,0,1,0,Algeria,Ghana,1334,1467,-133,133
1833,2014-10-14,Zambia,0,Nigeria,6,6,0,Nigeria,Zambia,1623,986,637,-637
1834,2014-10-14,Namibia,1,Côte d'Ivoire,3,3,1,Côte d'Ivoire,Namibia,1376,1021,355,-355
1835,2014-10-15,Cameroon,2,Algeria,0,2,0,Cameroon,Algeria,1457,1334,123,-123
1836,2014-10-15,Ghana,1,South Africa,1,1,1,Ghana,South Africa,1467,1423,44,-44
1837,2014-10-15,Guatemala,0,Haiti,1,1,0,Haiti,Guatemala,1393,1313,80,-80
1838,2014-10-15,USA,1,Trinidad and Tobago,0,1,0,USA,Trinidad and Tobago,2185,1505,680,-680
1839,2014-10-16,Costa Rica,1,Mexico,0,1,0,Costa Rica,Mexico,1566,1760,-194,194
1840,2014-10-17,Namibia,0,Nigeria,2,2,0,Nigeria,Namibia,1623,1021,602,-602
1841,2014-10-17,Zambia,1,Côte d'Ivoire,1,1,1,Zambia,Côte d'Ivoire,986,1376,-390,390
1842,2014-10-17,Haiti,0,Trinidad and Tobago,1,1,0,Trinidad and Tobago,Haiti,1505,1393,112,-112
1843,2014-10-17,USA,5,Guatemala,0,5,0,USA,Guatemala,2185,1313,872,-872
1844,2014-10-18,South Africa,5,Algeria,1,5,1,South Africa,Algeria,1423,1334,89,-89
1845,2014-10-18,Cameroon,0,Ghana,1,1,0,Ghana,Cameroon,1467,1457,10,-10
1846,2014-10-18,Costa Rica,2,Jamaica,1,2,1,Costa Rica,Jamaica,1566,1354,212,-212
1847,2014-10-20,Trinidad and Tobago,2,Guatemala,1,2,1,Trinidad and Tobago,Guatemala,1505,1313,192,-192
1848,2014-10-20,USA,6,Haiti,0,6,0,USA,Haiti,2185,1393,792,-792
1849,2014-10-21,Mexico,3,Jamaica,1,3,1,Mexico,Jamaica,1760,1354,406,-406
1850,2014-10-22,Nigeria,2,South Africa,1,2,1,Nigeria,South Africa,1623,1423,200,-200
1851,2014-10-22,Cameroon,2,Côte d'Ivoire,1,2,1,Cameroon,Côte d'Ivoire,1457,1376,81,-81
1852,2014-10-24,Costa Rica,1,Trinidad and Tobago,1,1,1,Costa Rica,Trinidad and Tobago,1566,1505,61,-61
1853,2014-10-24,USA,3,Mexico,0,3,0,USA,Mexico,2185,1760,425,-425
1854,2014-10-25,South Africa,0,Côte d'Ivoire,1,1,0,Côte d'Ivoire,South Africa,1376,1423,-47,47
1855,2014-10-25,Nigeria,2,Cameroon,0,2,0,Nigeria,Cameroon,1623,1457,166,-166
1856,2014-10-25,New Zealand,16,Tonga,0,16,0,New Zealand,Tonga,1815,1316,499,-499
1857,2014-10-25,Papua New Guinea,4,Cook Islands,1,4,1,Papua New Guinea,Cook Islands,1476,1170,306,-306
1858,2014-10-26,Trinidad and Tobago,2,Mexico,4,4,2,Mexico,Trinidad and Tobago,1760,1505,255,-255
1859,2014-10-26,USA,6,Costa Rica,0,6,0,USA,Costa Rica,2185,1566,619,-619
1860,2014-10-27,Tonga,1,Cook Islands,1,1,1,Tonga,Cook Islands,1316,1170,146,-146
1861,2014-10-27,Papua New Guinea,0,New Zealand,3,3,0,New Zealand,Papua New Guinea,1815,1476,339,-339
1862,2014-10-29,Cook Islands,0,New Zealand,11,11,0,New Zealand,Cook Islands,1815,1170,645,-645
1863,2014-10-29,Papua New Guinea,3,Tonga,0,3,0,Papua New Guinea,Tonga,1476,1316,160,-160
1864,2014-12-11,China PR,1,USA,1,1,1,China PR,USA,1869,2185,-316,316
1865,2014-12-15,Brazil,3,USA,2,3,2,Brazil,USA,2002,2185,-183,183
1866,2014-12-19,USA,7,Argentina,0,7,0,USA,Argentina,2185,1605,580,-580
1866,2014-12-19,USA,7,Argentina,0,7,0,USA,Argentina,2185,1617,568,-568
1866,2014-12-19,USA,7,Argentina,0,7,0,USA,Argentina,2158,1605,553,-553
1866,2014-12-19,USA,7,Argentina,0,7,0,USA,Argentina,2158,1617,541,-541
1867,2014-12-22,Brazil,0,USA,0,0,0,Brazil,USA,1968,2158,-190,190
1868,2015-01-11,Canada,2,Korea Republic,1,2,1,Canada,Korea Republic,1962,1836,126,-126
1869,2015-01-11,China PR,0,Mexico,0,0,0,China PR,Mexico,1880,1737,143,-143
1870,2015-01-13,Canada,2,Mexico,1,2,1,Canada,Mexico,1962,1737,225,-225
1871,2015-01-13,China PR,2,Korea Republic,3,3,2,Korea Republic,China PR,1836,1880,-44,44
1872,2015-01-15,China PR,1,Canada,2,2,1,Canada,China PR,1962,1880,82,-82
1873,2015-01-15,Korea Republic,2,Mexico,1,2,1,Korea Republic,Mexico,1836,1737,99,-99
1874,2015-02-08,France,2,USA,0,2,0,France,USA,2091,2158,-67,67
1875,2015-02-14,England,0,USA,1,1,0,USA,England,2158,1984,174,-174
1876,2015-03-04,Brazil,0,China PR,0,0,0,Brazil,China PR,1968,1880,88,-88
1877,2015-03-04,Germany,2,Sweden,4,4,2,Sweden,Germany,2000,2176,-176,176
1878,2015-03-04,Switzerland,2,Iceland,0,2,0,Switzerland,Iceland,1826,1818,8,-8
1879,2015-03-04,Norway,1,USA,2,2,1,USA,Norway,2158,1928,230,-230
1880,2015-03-04,Japan,1,Denmark,2,2,1,Denmark,Japan,1855,2084,-229,229
1881,2015-03-04,Portugal,0,France,1,1,0,France,Portugal,2091,1551,540,-540
1882,2015-03-04,Korea Republic,1,Italy,2,2,1,Italy,Korea Republic,1879,1836,43,-43
1883,2015-03-04,Scotland,0,Canada,2,2,0,Canada,Scotland,1962,1783,179,-179
1884,2015-03-04,Finland,1,England,3,3,1,England,Finland,1984,1778,206,-206
1885,2015-03-04,Netherlands,0,Australia,1,1,0,Australia,Netherlands,1957,1933,24,-24
1886,2015-03-04,Mexico,2,South Africa,0,2,0,Mexico,South Africa,1737,1405,332,-332
1887,2015-03-04,Czech Republic,2,Belgium,2,2,2,Czech Republic,Belgium,1657,1710,-53,53
1888,2015-03-06,Germany,2,China PR,0,2,0,Germany,China PR,2176,1880,296,-296
1889,2015-03-06,Sweden,0,Brazil,2,2,0,Brazil,Sweden,1968,2000,-32,32
1890,2015-03-06,USA,3,Switzerland,0,3,0,USA,Switzerland,2158,1826,332,-332
1891,2015-03-06,Norway,1,Iceland,0,1,0,Norway,Iceland,1928,1818,110,-110
1892,2015-03-06,Portugal,0,Japan,3,3,0,Japan,Portugal,2084,1551,533,-533
1893,2015-03-06,France,4,Denmark,1,4,1,France,Denmark,2091,1855,236,-236
1894,2015-03-06,Canada,1,Korea Republic,0,1,0,Canada,Korea Republic,1962,1836,126,-126
1895,2015-03-06,Italy,3,Scotland,2,3,2,Italy,Scotland,1879,1783,96,-96
1896,2015-03-06,Finland,0,Netherlands,0,0,0,Finland,Netherlands,1778,1933,-155,155
1897,2015-03-06,Australia,0,England,3,3,0,England,Australia,1984,1957,27,-27
1898,2015-03-06,Belgium,0,South Africa,1,1,0,South Africa,Belgium,1405,1710,-305,305
1899,2015-03-06,Czech Republic,0,Mexico,1,1,0,Mexico,Czech Republic,1737,1657,80,-80
1900,2015-03-09,Brazil,1,Germany,3,3,1,Germany,Brazil,2176,1968,208,-208
1901,2015-03-09,Sweden,3,China PR,0,3,0,Sweden,China PR,2000,1880,120,-120
1902,2015-03-09,USA,0,Iceland,0,0,0,USA,Iceland,2158,1818,340,-340
1903,2015-03-09,Norway,2,Switzerland,2,2,2,Norway,Switzerland,1928,1826,102,-102
1904,2015-03-09,Japan,1,France,3,3,1,France,Japan,2091,2084,7,-7
1905,2015-03-09,Portugal,2,Denmark,2,2,2,Portugal,Denmark,1551,1855,-304,304
1906,2015-03-09,Italy,0,Canada,1,1,0,Canada,Italy,1962,1879,83,-83
1907,2015-03-09,Scotland,2,Korea Republic,1,2,1,Scotland,Korea Republic,1783,1836,-53,53
1908,2015-03-09,Netherlands,1,England,1,1,1,Netherlands,England,1933,1984,-51,51
1909,2015-03-09,Australia,3,Finland,0,3,0,Australia,Finland,1957,1778,179,-179
1910,2015-03-09,South Africa,0,Czech Republic,1,1,0,Czech Republic,South Africa,1657,1405,252,-252
1911,2015-03-09,Mexico,0,Belgium,0,0,0,Mexico,Belgium,1737,1710,27,-27
1912,2015-03-11,Portugal,3,China PR,3,3,3,Portugal,China PR,1551,1880,-329,329
1913,2015-03-11,Japan,2,Iceland,0,2,0,Japan,Iceland,2084,1818,266,-266
1914,2015-03-11,Brazil,4,Switzerland,1,4,1,Brazil,Switzerland,1968,1826,142,-142
1915,2015-03-11,Norway,5,Denmark,2,5,2,Norway,Denmark,1928,1855,73,-73
1916,2015-03-11,Sweden,1,Germany,2,2,1,Germany,Sweden,2176,2000,176,-176
1917,2015-03-11,France,0,USA,2,2,0,USA,France,2158,2091,67,-67
1918,2015-03-11,Korea Republic,1,Belgium,1,1,1,Korea Republic,Belgium,1836,1710,126,-126
1919,2015-03-11,Finland,2,South Africa,1,2,1,Finland,South Africa,1778,1405,373,-373
1920,2015-03-11,Scotland,3,Netherlands,1,3,1,Scotland,Netherlands,1783,1933,-150,150
1921,2015-03-11,Australia,6,Czech Republic,2,6,2,Australia,Czech Republic,1957,1657,300,-300
1922,2015-03-11,Italy,2,Mexico,3,3,2,Mexico,Italy,1737,1879,-142,142
1923,2015-03-11,Canada,0,England,1,1,0,England,Canada,1984,1962,22,-22
1924,2015-04-04,Luxembourg,4,Latvia,3,4,3,Luxembourg,Latvia,1146,1173,-27,27
1925,2015-04-04,Moldova,2,Lithuania,0,2,0,Moldova,Lithuania,1177,1231,-54,54
1926,2015-04-04,Georgia,2,Faroe Islands,0,2,0,Georgia,Faroe Islands,1099,1295,-196,196
1927,2015-04-04,Andorra,3,Malta,5,5,3,Malta,Andorra,1152,763,389,-389
1928,2015-04-05,USA,4,New Zealand,0,4,0,USA,New Zealand,2158,1832,326,-326
1929,2015-04-06,Lithuania,2,Luxembourg,0,2,0,Lithuania,Luxembourg,1231,1146,85,-85
1930,2015-04-06,Moldova,0,Latvia,1,1,0,Latvia,Moldova,1173,1177,-4,4
1931,2015-04-06,Faroe Islands,8,Andorra,0,8,0,Faroe Islands,Andorra,1295,763,532,-532
1932,2015-04-06,Georgia,1,Malta,2,2,1,Malta,Georgia,1152,1099,53,-53
1933,2015-04-09,Luxembourg,0,Moldova,3,3,0,Moldova,Luxembourg,1177,1146,31,-31
1934,2015-04-09,Latvia,1,Lithuania,1,1,1,Latvia,Lithuania,1173,1231,-58,58
1935,2015-04-09,Malta,2,Faroe Islands,4,4,2,Faroe Islands,Malta,1295,1152,143,-143
1936,2015-04-09,Andorra,0,Georgia,7,7,0,Georgia,Andorra,1099,763,336,-336
1937,2015-05-10,USA,3,Republic of Ireland,0,3,0,USA,Republic of Ireland,2158,1653,505,-505
1938,2015-05-18,USA,5,Mexico,1,5,1,USA,Mexico,2158,1748,410,-410
1939,2015-05-31,USA,0,Korea Republic,0,0,0,USA,Korea Republic,2158,1830,328,-328
1940,2015-06-06,Canada,1,China PR,0,1,0,Canada,China PR,1969,1847,122,-122
1941,2015-06-06,New Zealand,0,Netherlands,1,1,0,Netherlands,New Zealand,1919,1832,87,-87
1942,2015-06-07,Norway,4,Thailand,0,4,0,Norway,Thailand,1933,1654,279,-279
1943,2015-06-07,Germany,10,Côte d'Ivoire,0,10,0,Germany,Côte d'Ivoire,2168,1373,795,-795
1944,2015-06-08,Cameroon,6,Ecuador,0,6,0,Cameroon,Ecuador,1455,1485,-30,30
1945,2015-06-08,Japan,1,Switzerland,0,1,0,Japan,Switzerland,2066,1813,253,-253
1946,2015-06-08,Sweden,3,Nigeria,3,3,3,Sweden,Nigeria,2008,1633,375,-375
1947,2015-06-08,USA,3,Australia,1,3,1,USA,Australia,2158,1968,190,-190
1948,2015-06-09,Spain,1,Costa Rica,1,1,1,Spain,Costa Rica,1867,1589,278,-278
1949,2015-06-09,Brazil,2,Korea Republic,0,2,0,Brazil,Korea Republic,1984,1830,154,-154
1950,2015-06-09,France,1,England,0,1,0,France,England,2103,2001,102,-102
1951,2015-06-09,Colombia,1,Mexico,1,1,1,Colombia,Mexico,1692,1748,-56,56
1952,2015-06-11,China PR,1,Netherlands,0,1,0,China PR,Netherlands,1847,1919,-72,72
1953,2015-06-11,Canada,0,New Zealand,0,0,0,Canada,New Zealand,1969,1832,137,-137
1954,2015-06-11,Germany,1,Norway,1,1,1,Germany,Norway,2168,1933,235,-235
1955,2015-06-11,Côte d'Ivoire,2,Thailand,3,3,2,Thailand,Côte d'Ivoire,1654,1373,281,-281
1956,2015-06-12,Switzerland,10,Ecuador,1,10,1,Switzerland,Ecuador,1813,1485,328,-328
1957,2015-06-12,Japan,2,Cameroon,1,2,1,Japan,Cameroon,2066,1455,611,-611
1958,2015-06-12,Australia,2,Nigeria,0,2,0,Australia,Nigeria,1968,1633,335,-335
1959,2015-06-12,USA,0,Sweden,0,0,0,USA,Sweden,2158,2008,150,-150
1960,2015-06-13,Brazil,1,Spain,0,1,0,Brazil,Spain,1984,1867,117,-117
1961,2015-06-13,Korea Republic,2,Costa Rica,2,2,2,Korea Republic,Costa Rica,1830,1589,241,-241
1962,2015-06-13,France,0,Colombia,2,2,0,Colombia,France,1692,2103,-411,411
1963,2015-06-13,England,2,Mexico,1,2,1,England,Mexico,2001,1748,253,-253
1964,2015-06-15,Canada,1,Netherlands,1,1,1,Canada,Netherlands,1969,1919,50,-50
1965,2015-06-15,China PR,2,New Zealand,2,2,2,China PR,New Zealand,1847,1832,15,-15
1966,2015-06-15,Thailand,0,Germany,4,4,0,Germany,Thailand,2168,1654,514,-514
1967,2015-06-15,Côte d'Ivoire,1,Norway,3,3,1,Norway,Côte d'Ivoire,1933,1373,560,-560
1968,2015-06-16,Ecuador,0,Japan,1,1,0,Japan,Ecuador,2066,1485,581,-581
1969,2015-06-16,Switzerland,1,Cameroon,2,2,1,Cameroon,Switzerland,1455,1813,-358,358
1970,2015-06-16,Nigeria,0,USA,1,1,0,USA,Nigeria,2158,1633,525,-525
1971,2015-06-16,Australia,1,Sweden,1,1,1,Australia,Sweden,1968,2008,-40,40
1972,2015-06-17,Costa Rica,0,Brazil,1,1,0,Brazil,Costa Rica,1984,1589,395,-395
1973,2015-06-17,Korea Republic,2,Spain,1,2,1,Korea Republic,Spain,1830,1867,-37,37
1974,2015-06-17,Mexico,0,France,5,5,0,France,Mexico,2103,1748,355,-355
1975,2015-06-17,England,2,Colombia,1,2,1,England,Colombia,2001,1692,309,-309
1976,2015-06-20,Germany,4,Sweden,1,4,1,Germany,Sweden,2168,2008,160,-160
1977,2015-06-20,China PR,1,Cameroon,0,1,0,China PR,Cameroon,1847,1455,392,-392
1978,2015-06-21,Brazil,0,Australia,1,1,0,Australia,Brazil,1968,1984,-16,16
1979,2015-06-21,France,3,Korea Republic,0,3,0,France,Korea Republic,2103,1830,273,-273
1980,2015-06-21,Canada,1,Switzerland,0,1,0,Canada,Switzerland,1969,1813,156,-156
1981,2015-06-22,Norway,1,England,2,2,1,England,Norway,2001,1933,68,-68
1982,2015-06-22,USA,2,Colombia,0,2,0,USA,Colombia,2158,1692,466,-466
1983,2015-06-23,Japan,2,Netherlands,1,2,1,Japan,Netherlands,2066,1919,147,-147
1984,2015-06-26,Germany,1,France,1,1,1,Germany,France,2168,2103,65,-65
1985,2015-06-26,China PR,0,USA,1,1,0,USA,China PR,2158,1847,311,-311
1986,2015-06-27,Australia,0,Japan,1,1,0,Japan,Australia,2066,1968,98,-98
1987,2015-06-27,Canada,1,England,2,2,1,England,Canada,2001,1969,32,-32
1988,2015-06-30,USA,2,Germany,0,2,0,USA,Germany,2158,2168,-10,10
1989,2015-07-01,Japan,2,England,1,2,1,Japan,England,2066,2001,65,-65
1990,2015-07-04,Germany,0,England,1,1,0,England,Germany,2001,2168,-167,167
1991,2015-07-05,USA,5,Japan,2,5,2,USA,Japan,2158,2066,92,-92
1992,2015-08-16,USA,8,Costa Rica,0,8,0,USA,Costa Rica,2189,1627,562,-562
1993,2015-08-20,USA,7,Costa Rica,2,7,2,USA,Costa Rica,2189,1627,562,-562
1994,2015-09-17,Finland,1,Montenegro,0,1,0,Finland,Montenegro,1758,1237,521,-521
1995,2015-09-17,Moldova,0,Sweden,3,3,0,Sweden,Moldova,1971,1180,791,-791
1996,2015-09-17,Turkey,1,Croatia,4,4,1,Croatia,Turkey,1413,1411,2,-2
1997,2015-09-17,Estonia,0,Serbia,1,1,0,Serbia,Estonia,1533,1339,194,-194
1998,2015-09-17,Kazakhstan,0,Austria,2,2,0,Austria,Kazakhstan,1719,1354,365,-365
1999,2015-09-18,USA,5,Haiti,0,5,0,USA,Haiti,2189,1397,792,-792
2000,2015-09-18,Germany,12,Hungary,0,12,0,Germany,Hungary,2115,1566,549,-549
2001,2015-09-18,Italy,6,Georgia,1,6,1,Italy,Georgia,1875,1115,760,-760
2002,2015-09-20,USA,8,Haiti,0,8,0,USA,Haiti,2189,1397,792,-792
2003,2015-09-21,Republic of Ireland,0,Finland,2,2,0,Finland,Republic of Ireland,1758,1653,105,-105
2004,2015-09-21,Estonia,0,England,8,8,0,England,Estonia,2038,1339,699,-699
2005,2015-09-22,Slovenia,0,Scotland,3,3,0,Scotland,Slovenia,1797,1391,406,-406
2006,2015-09-22,Iceland,2,Belarus,0,2,0,Iceland,Belarus,1817,1475,342,-342
2007,2015-09-22,France,3,Romania,0,3,0,France,Romania,2081,1564,517,-517
2008,2015-09-22,Sweden,3,Poland,0,3,0,Sweden,Poland,1971,1654,317,-317
2009,2015-09-22,Croatia,0,Germany,1,1,0,Germany,Croatia,2115,1413,702,-702
2010,2015-09-22,Georgia,0,Czech Republic,3,3,0,Czech Republic,Georgia,1654,1115,539,-539
2011,2015-09-22,Belgium,6,Bosnia and Herzegovina,0,6,0,Belgium,Bosnia and Herzegovina,1708,1360,348,-348
2012,2015-09-22,Kazakhstan,0,Norway,4,4,0,Norway,Kazakhstan,1927,1354,573,-573
2013,2015-09-22,Austria,3,Wales,0,3,0,Austria,Wales,1719,1620,99,-99
2014,2015-10-19,Slovenia,3,Belarus,0,3,0,Slovenia,Belarus,1390,1476,-86,86
2015,2015-10-21,Hungary,1,Turkey,0,1,0,Hungary,Turkey,1565,1395,170,-170
2016,2015-10-22,USA,1,Brazil,1,1,1,USA,Brazil,2189,1973,216,-216
2017,2015-10-22,FYR Macedonia,0,Iceland,4,4,0,Iceland,FYR Macedonia,1818,1079,739,-739
2018,2015-10-22,Albania,1,Greece,4,4,1,Greece,Albania,1364,1322,42,-42
2019,2015-10-22,Ukraine,2,Romania,2,2,2,Ukraine,Romania,1770,1562,208,-208
2020,2015-10-22,Poland,2,Slovakia,0,2,0,Poland,Slovakia,1639,1525,114,-114
2021,2015-10-22,Denmark,4,Moldova,0,4,0,Denmark,Moldova,1856,1180,676,-676
2022,2015-10-22,Germany,2,Russia,0,2,0,Germany,Russia,2115,1779,336,-336
2023,2015-10-22,Israel,0,Kazakhstan,0,0,0,Israel,Kazakhstan,1424,1351,73,-73
2024,2015-10-23,Scotland,7,Belarus,0,7,0,Scotland,Belarus,1791,1476,315,-315
2025,2015-10-23,Bosnia and Herzegovina,4,Estonia,0,4,0,Bosnia and Herzegovina,Estonia,1360,1329,31,-31
2026,2015-10-23,Norway,4,Wales,0,4,0,Norway,Wales,1933,1620,313,-313
2027,2015-10-24,Italy,0,Switzerland,3,3,0,Switzerland,Italy,1781,1874,-93,93
2028,2015-10-24,Georgia,0,Northern Ireland,3,3,0,Northern Ireland,Georgia,1376,1116,260,-260
2029,2015-10-25,USA,3,Brazil,1,3,1,USA,Brazil,2189,1973,216,-216
2030,2015-10-25,Germany,7,Turkey,0,7,0,Germany,Turkey,2115,1395,720,-720
2031,2015-10-25,Croatia,1,Hungary,1,1,1,Croatia,Hungary,1436,1565,-129,129
2032,2015-10-25,Israel,0,Austria,1,1,0,Austria,Israel,1722,1424,298,-298
2033,2015-10-26,Slovenia,0,Iceland,6,6,0,Iceland,Slovenia,1818,1390,428,-428
2034,2015-10-26,Slovakia,4,Moldova,0,4,0,Slovakia,Moldova,1525,1180,345,-345
2035,2015-10-27,FYR Macedonia,1,Scotland,4,4,1,Scotland,FYR Macedonia,1791,1079,712,-712
2036,2015-10-27,Portugal,1,Republic of Ireland,2,2,1,Republic of Ireland,Portugal,1653,1580,73,-73
2037,2015-10-27,Finland,1,Spain,2,2,1,Spain,Finland,1824,1754,70,-70
2038,2015-10-27,Romania,3,Albania,0,3,0,Romania,Albania,1562,1322,240,-240
2039,2015-10-27,Ukraine,0,France,3,3,0,France,Ukraine,2083,1770,313,-313
2040,2015-10-27,Sweden,1,Denmark,0,1,0,Sweden,Denmark,1970,1856,114,-114
2041,2015-10-27,Czech Republic,0,Italy,3,3,0,Italy,Czech Republic,1874,1654,220,-220
2042,2015-10-27,Switzerland,4,Georgia,0,4,0,Switzerland,Georgia,1781,1116,665,-665
2043,2015-10-27,Serbia,3,Estonia,0,3,0,Serbia,Estonia,1540,1329,211,-211
2044,2015-10-27,Bosnia and Herzegovina,0,Belgium,5,5,0,Belgium,Bosnia and Herzegovina,1712,1360,352,-352
2045,2015-11-25,Turkey,0,Russia,0,0,0,Turkey,Russia,1395,1779,-384,384
2046,2015-11-25,Serbia,0,Bosnia and Herzegovina,1,1,0,Bosnia and Herzegovina,Serbia,1360,1540,-180,180
2047,2015-11-26,FYR Macedonia,0,Belarus,2,2,0,Belarus,FYR Macedonia,1476,1079,397,-397
2048,2015-11-26,Republic of Ireland,0,Spain,3,3,0,Spain,Republic of Ireland,1824,1653,171,-171
2049,2015-11-26,Portugal,6,Montenegro,1,6,1,Portugal,Montenegro,1580,1241,339,-339
2050,2015-11-26,Slovakia,0,Denmark,1,1,0,Denmark,Slovakia,1856,1525,331,-331
2051,2015-11-26,Wales,4,Kazakhstan,0,4,0,Wales,Kazakhstan,1620,1351,269,-269
2052,2015-11-27,Greece,1,Romania,3,3,1,Romania,Greece,1562,1364,198,-198
2053,2015-11-27,Albania,0,France,6,6,0,France,Albania,2083,1322,761,-761
2054,2015-11-27,Moldova,1,Poland,3,3,1,Poland,Moldova,1639,1180,459,-459
2055,2015-11-27,Northern Ireland,1,Switzerland,8,8,1,Switzerland,Northern Ireland,1781,1376,405,-405
2056,2015-11-29,Scotland,10,FYR Macedonia,0,10,0,Scotland,FYR Macedonia,1791,1079,712,-712
2057,2015-11-29,Hungary,0,Russia,1,1,0,Russia,Hungary,1779,1565,214,-214
2058,2015-11-29,England,1,Bosnia and Herzegovina,0,1,0,England,Bosnia and Herzegovina,2038,1360,678,-678
2059,2015-11-30,Croatia,3,Turkey,0,3,0,Croatia,Turkey,1436,1395,41,-41
2060,2015-11-30,Belgium,1,Serbia,1,1,1,Belgium,Serbia,1712,1540,172,-172
2061,2015-12-01,Spain,2,Portugal,0,2,0,Spain,Portugal,1824,1580,244,-244
2062,2015-12-01,Greece,0,France,3,3,0,France,Greece,2083,1364,719,-719
2063,2015-12-01,Moldova,0,Slovakia,4,4,0,Slovakia,Moldova,1525,1180,345,-345
2064,2015-12-01,Switzerland,5,Czech Republic,1,5,1,Switzerland,Czech Republic,1781,1654,127,-127
2065,2015-12-01,Israel,2,Wales,2,2,2,Israel,Wales,1424,1620,-196,196
2066,2015-12-07,USA,0,Trinidad and Tobago,0,0,0,USA,Trinidad and Tobago,2189,1489,700,-700
2067,2015-12-11,USA,6,Trinidad and Tobago,0,6,0,USA,Trinidad and Tobago,2189,1489,700,-700
2068,2015-12-14,USA,2,China PR,0,2,0,USA,China PR,2189,1840,349,-349
2069,2015-12-17,USA,0,China PR,1,1,0,China PR,USA,1840,2189,-349,349
2070,2016-01-21,China PR,0,Mexico,0,0,0,China PR,Mexico,1844,1731,113,-113
2071,2016-01-21,Korea Republic,5,Vietnam,0,5,0,Korea Republic,Vietnam,1833,1650,183,-183
2072,2016-01-23,Mexico,2,Korea Republic,0,2,0,Mexico,Korea Republic,1731,1833,-102,102
2073,2016-01-23,China PR,8,Vietnam,0,8,0,China PR,Vietnam,1844,1650,194,-194
2074,2016-01-24,USA,5,Republic of Ireland,0,5,0,USA,Republic of Ireland,2180,1642,538,-538
2075,2016-01-24,Montenegro,0,Spain,7,7,0,Spain,Montenegro,1854,1239,615,-615
2076,2016-01-26,Greece,3,Albania,2,3,2,Greece,Albania,1372,1304,68,-68
2077,2016-01-26,China PR,2,Korea Republic,0,2,0,China PR,Korea Republic,1844,1833,11,-11
2078,2016-01-26,Mexico,1,Vietnam,0,1,0,Mexico,Vietnam,1731,1650,81,-81
2079,2016-02-11,USA,5,Costa Rica,0,5,0,USA,Costa Rica,2180,1630,550,-550
2080,2016-02-14,USA,1,Mexico,0,1,0,USA,Mexico,2180,1731,449,-449
2081,2016-02-16,USA,10,Puerto Rico,0,10,0,USA,Puerto Rico,2180,1159,1021,-1021
2082,2016-02-20,USA,5,Trinidad and Tobago,0,5,0,USA,Trinidad and Tobago,2180,1485,695,-695
2083,2016-02-22,USA,2,Canada,0,2,0,USA,Canada,2180,1928,252,-252
2084,2016-03-02,Iceland,2,Belgium,1,2,1,Iceland,Belgium,1821,1709,112,-112
2085,2016-03-02,Canada,0,Denmark,1,1,0,Denmark,Canada,1849,1928,-79,79
2086,2016-03-02,Portugal,0,Russia,1,1,0,Russia,Portugal,1774,1565,209,-209
2087,2016-03-02,Brazil,1,New Zealand,0,1,0,Brazil,New Zealand,1977,1846,131,-131
2088,2016-03-02,Austria,2,Republic of Ireland,0,2,0,Austria,Republic of Ireland,1730,1642,88,-88
2089,2016-03-02,Hungary,0,Italy,2,2,0,Italy,Hungary,1859,1558,301,-301
2090,2016-03-02,Wales,2,Finland,2,2,2,Wales,Finland,1611,1755,-144,144
2091,2016-03-02,Poland,1,Czech Republic,0,1,0,Poland,Czech Republic,1643,1641,2,-2
2092,2016-03-03,Germany,1,France,0,1,0,Germany,France,2104,2078,26,-26
2093,2016-03-03,USA,1,England,0,1,0,USA,England,2180,2041,139,-139
2094,2016-03-04,Tanzania,1,Zimbabwe,2,2,1,Zimbabwe,Tanzania,1208,939,269,-269
2095,2016-03-04,Albania,0,Ukraine,4,4,0,Ukraine,Albania,1758,1304,454,-454
2096,2016-03-04,Canada,1,Belgium,0,1,0,Canada,Belgium,1928,1709,219,-219
2097,2016-03-04,Denmark,1,Iceland,4,4,1,Iceland,Denmark,1821,1849,-28,28
2098,2016-03-04,New Zealand,0,Russia,0,0,0,New Zealand,Russia,1846,1774,72,-72
2099,2016-03-04,Portugal,1,Brazil,3,3,1,Brazil,Portugal,1977,1565,412,-412
2100,2016-03-04,Austria,2,Hungary,1,2,1,Austria,Hungary,1730,1558,172,-172
2101,2016-03-04,Italy,1,Republic of Ireland,1,1,1,Italy,Republic of Ireland,1859,1642,217,-217
2102,2016-03-04,Wales,1,Poland,1,1,1,Wales,Poland,1611,1643,-32,32
2103,2016-03-04,Finland,1,Czech Republic,3,3,1,Czech Republic,Finland,1641,1755,-114,114
2104,2016-03-05,Mali,0,Morocco,0,0,0,Mali,Morocco,1196,1320,-124,124
2105,2016-03-05,Senegal,1,Guinea,0,1,0,Senegal,Guinea,1252,1063,189,-189
2106,2016-03-05,Burkina Faso,0,Tunisia,0,0,0,Burkina Faso,Tunisia,1038,1314,-276,276
2107,2016-03-05,Botswana,7,Mauritius,0,7,0,Botswana,Mauritius,730,335,395,-395
2108,2016-03-06,Zambia,3,Namibia,1,3,1,Zambia,Namibia,1015,1039,-24,24
2109,2016-03-06,Algeria,1,Ethiopia,0,1,0,Algeria,Ethiopia,1321,1154,167,-167
2110,2016-03-06,USA,1,France,0,1,0,USA,France,2180,2078,102,-102
2111,2016-03-06,Germany,2,England,1,2,1,Germany,England,2104,2041,63,-63
2112,2016-03-07,Denmark,1,Belgium,2,2,1,Belgium,Denmark,1709,1849,-140,140
2113,2016-03-07,Canada,1,Iceland,0,1,0,Canada,Iceland,1928,1821,107,-107
2114,2016-03-07,Brazil,3,Russia,0,3,0,Brazil,Russia,1977,1774,203,-203
2115,2016-03-07,Portugal,0,New Zealand,1,1,0,New Zealand,Portugal,1846,1565,281,-281
2116,2016-03-07,Italy,0,Austria,0,0,0,Italy,Austria,1859,1730,129,-129
2117,2016-03-07,Republic of Ireland,0,Hungary,1,1,0,Hungary,Republic of Ireland,1558,1642,-84,84
2118,2016-03-07,Finland,0,Poland,1,1,0,Poland,Finland,1643,1755,-112,112
2119,2016-03-07,Czech Republic,1,Wales,0,1,0,Czech Republic,Wales,1641,1611,30,-30
2120,2016-03-08,Greece,1,Ukraine,3,3,1,Ukraine,Greece,1758,1372,386,-386
2121,2016-03-09,Portugal,1,Denmark,3,3,1,Denmark,Portugal,1849,1565,284,-284
2122,2016-03-09,Belgium,5,Russia,0,5,0,Belgium,Russia,1709,1774,-65,65
2123,2016-03-09,Iceland,1,New Zealand,1,1,1,Iceland,New Zealand,1821,1846,-25,25
2124,2016-03-09,Canada,2,Brazil,1,2,1,Canada,Brazil,1928,1977,-49,49
2125,2016-03-09,France,0,England,0,0,0,France,England,2078,2041,37,-37
2126,2016-03-09,USA,2,Germany,1,2,1,USA,Germany,2180,2104,76,-76
2127,2016-03-09,Republic of Ireland,2,Finland,0,2,0,Republic of Ireland,Finland,1642,1755,-113,113
2128,2016-03-09,Hungary,2,Wales,1,2,1,Hungary,Wales,1558,1611,-53,53
2129,2016-03-09,Italy,3,Czech Republic,1,3,1,Italy,Czech Republic,1859,1641,218,-218
2130,2016-03-09,Austria,2,Poland,1,2,1,Austria,Poland,1730,1643,87,-87
2131,2016-03-18,Namibia,2,Zambia,2,2,2,Namibia,Zambia,1039,1015,24,-24
2132,2016-03-19,Morocco,1,Mali,2,2,1,Mali,Morocco,1196,1320,-124,124
2133,2016-03-19,Guinea,1,Senegal,0,1,0,Guinea,Senegal,1063,1252,-189,189
2134,2016-03-19,Tunisia,2,Burkina Faso,0,2,0,Tunisia,Burkina Faso,1314,1038,276,-276
2135,2016-03-19,Mauritius,0,Botswana,4,4,0,Botswana,Mauritius,730,335,395,-395
2136,2016-03-20,Zimbabwe,1,Tanzania,1,1,1,Zimbabwe,Tanzania,1208,939,269,-269
2137,2016-03-26,Ethiopia,1,Algeria,1,1,1,Ethiopia,Algeria,1153,1311,-158,158
2138,2016-04-06,Israel,0,Norway,1,1,0,Norway,Israel,1923,1423,500,-500
2139,2016-04-06,Austria,6,Kazakhstan,1,6,1,Austria,Kazakhstan,1741,1354,387,-387
2140,2016-04-06,Mali,1,Equatorial Guinea,1,1,1,Mali,Equatorial Guinea,1216,1452,-236,236
2141,2016-04-06,Zimbabwe,1,Zambia,0,1,0,Zimbabwe,Zambia,1200,1029,171,-171
2142,2016-04-06,Tunisia,1,Ghana,2,2,1,Ghana,Tunisia,1475,1325,150,-150
2143,2016-04-07,USA,7,Colombia,0,7,0,USA,Colombia,2174,1747,427,-427
2144,2016-04-07,Montenegro,0,Republic of Ireland,5,5,0,Republic of Ireland,Montenegro,1643,1238,405,-405
2145,2016-04-07,Poland,0,Denmark,0,0,0,Poland,Denmark,1654,1836,-182,182
2146,2016-04-07,Egypt,1,Côte d'Ivoire,0,1,0,Egypt,Côte d'Ivoire,1278,1395,-117,117
2147,2016-04-08,Scotland,3,Slovenia,1,3,1,Scotland,Slovenia,1793,1396,397,-397
2148,2016-04-08,Portugal,1,Spain,4,4,1,Spain,Portugal,1852,1556,296,-296
2149,2016-04-08,Ukraine,2,Albania,0,2,0,Ukraine,Albania,1760,1298,462,-462
2150,2016-04-08,Romania,0,France,1,1,0,France,Romania,2068,1585,483,-483
2151,2016-04-08,Slovakia,0,Sweden,3,3,0,Sweden,Slovakia,1995,1534,461,-461
2152,2016-04-08,Turkey,0,Germany,6,6,0,Germany,Turkey,2117,1395,722,-722
2153,2016-04-08,Hungary,2,Croatia,0,2,0,Hungary,Croatia,1569,1434,135,-135
2154,2016-04-08,England,1,Belgium,1,1,1,England,Belgium,2033,1721,312,-312
2155,2016-04-08,Algeria,2,Kenya,2,2,2,Algeria,Kenya,1311,796,515,-515
2156,2016-04-08,Senegal,1,Nigeria,1,1,1,Senegal,Nigeria,1238,1602,-364,364
2157,2016-04-09,Switzerland,2,Italy,1,2,1,Switzerland,Italy,1833,1855,-22,22
2158,2016-04-09,Botswana,0,South Africa,2,2,0,South Africa,Botswana,1431,730,701,-701
2159,2016-04-10,USA,3,Colombia,0,3,0,USA,Colombia,2174,1747,427,-427
2160,2016-04-10,Austria,0,Norway,1,1,0,Norway,Austria,1923,1741,182,-182
2161,2016-04-10,Equatorial Guinea,2,Mali,1,2,1,Equatorial Guinea,Mali,1452,1216,236,-236
2162,2016-04-10,Zambia,2,Zimbabwe,3,3,2,Zimbabwe,Zambia,1200,1029,171,-171
2163,2016-04-11,France,4,Ukraine,0,4,0,France,Ukraine,2068,1760,308,-308
2164,2016-04-11,Côte d'Ivoire,2,Egypt,1,2,1,Côte d'Ivoire,Egypt,1395,1278,117,-117
2165,2016-04-12,Belarus,0,Iceland,5,5,0,Iceland,Belarus,1828,1463,365,-365
2166,2016-04-12,Slovenia,8,FYR Macedonia,1,8,1,Slovenia,FYR Macedonia,1396,1077,319,-319
2167,2016-04-12,Montenegro,1,Finland,7,7,1,Finland,Montenegro,1728,1238,490,-490
2168,2016-04-12,Spain,3,Republic of Ireland,0,3,0,Spain,Republic of Ireland,1852,1643,209,-209
2169,2016-04-12,Slovakia,2,Poland,1,2,1,Slovakia,Poland,1534,1654,-120,120
2170,2016-04-12,Germany,2,Croatia,0,2,0,Germany,Croatia,2117,1434,683,-683
2171,2016-04-12,Russia,3,Hungary,3,3,3,Russia,Hungary,1767,1569,198,-198
2172,2016-04-12,Czech Republic,4,Georgia,1,4,1,Czech Republic,Georgia,1647,1126,521,-521
2173,2016-04-12,Italy,3,Northern Ireland,1,3,1,Italy,Northern Ireland,1855,1386,469,-469
2174,2016-04-12,Bosnia and Herzegovina,0,England,1,1,0,England,Bosnia and Herzegovina,2033,1386,647,-647
2175,2016-04-12,Belgium,6,Estonia,0,6,0,Belgium,Estonia,1721,1287,434,-434
2176,2016-04-12,Kazakhstan,0,Wales,4,4,0,Wales,Kazakhstan,1604,1354,250,-250
2177,2016-04-12,Kenya,1,Algeria,1,1,1,Kenya,Algeria,796,1311,-515,515
2178,2016-04-12,Nigeria,2,Senegal,0,2,0,Nigeria,Senegal,1602,1238,364,-364
2179,2016-04-12,Ghana,4,Tunisia,0,4,0,Ghana,Tunisia,1475,1325,150,-150
2180,2016-04-12,South Africa,3,Botswana,0,3,0,South Africa,Botswana,1431,730,701,-701
2181,2016-06-02,Albania,0,Romania,3,3,0,Romania,Albania,1585,1298,287,-287
2182,2016-06-02,Poland,0,Sweden,4,4,0,Sweden,Poland,1995,1654,341,-341
2183,2016-06-02,Denmark,4,Slovakia,0,4,0,Denmark,Slovakia,1836,1534,302,-302
2184,2016-06-02,Russia,2,Turkey,0,2,0,Russia,Turkey,1767,1395,372,-372
2185,2016-06-02,Kazakhstan,1,Israel,0,1,0,Kazakhstan,Israel,1354,1423,-69,69
2186,2016-06-02,Norway,2,Austria,2,2,2,Norway,Austria,1923,1741,182,-182
2187,2016-06-03,USA,3,Japan,3,3,3,USA,Japan,2174,1983,191,-191
2188,2016-06-03,FYR Macedonia,0,Slovenia,9,9,0,Slovenia,FYR Macedonia,1396,1077,319,-319
2189,2016-06-03,Scotland,0,Iceland,4,4,0,Iceland,Scotland,1828,1793,35,-35
2190,2016-06-03,Finland,4,Republic of Ireland,1,4,1,Finland,Republic of Ireland,1728,1643,85,-85
2191,2016-06-03,Montenegro,0,Portugal,3,3,0,Portugal,Montenegro,1556,1238,318,-318
2192,2016-06-03,France,1,Greece,0,1,0,France,Greece,2068,1373,695,-695
2193,2016-06-03,Northern Ireland,4,Georgia,0,4,0,Northern Ireland,Georgia,1386,1126,260,-260
2194,2016-06-03,Estonia,0,Belgium,5,5,0,Belgium,Estonia,1721,1287,434,-434
2195,2016-06-04,Czech Republic,0,Switzerland,5,5,0,Switzerland,Czech Republic,1833,1647,186,-186
2196,2016-06-04,England,7,Serbia,0,7,0,England,Serbia,2033,1532,501,-501
2197,2016-06-05,USA,0,Japan,0,0,0,USA,Japan,2174,1983,191,-191
2198,2016-06-06,Sweden,6,Moldova,0,6,0,Sweden,Moldova,1995,1174,821,-821
2199,2016-06-06,Turkey,2,Hungary,1,2,1,Turkey,Hungary,1395,1569,-174,174
2200,2016-06-06,Croatia,0,Russia,3,3,0,Russia,Croatia,1767,1434,333,-333
2201,2016-06-06,Estonia,0,Bosnia and Herzegovina,1,1,0,Bosnia and Herzegovina,Estonia,1386,1287,99,-99
2202,2016-06-06,Austria,4,Israel,0,4,0,Austria,Israel,1741,1423,318,-318
2203,2016-06-07,Belarus,0,Scotland,1,1,0,Scotland,Belarus,1793,1463,330,-330
2204,2016-06-07,Iceland,8,FYR Macedonia,0,8,0,Iceland,FYR Macedonia,1828,1077,751,-751
2205,2016-06-07,Finland,0,Portugal,0,0,0,Finland,Portugal,1728,1556,172,-172
2206,2016-06-07,Republic of Ireland,9,Montenegro,0,9,0,Republic of Ireland,Montenegro,1643,1238,405,-405
2207,2016-06-07,Ukraine,2,Greece,0,2,0,Ukraine,Greece,1760,1373,387,-387
2208,2016-06-07,Denmark,6,Poland,0,6,0,Denmark,Poland,1836,1654,182,-182
2209,2016-06-07,Georgia,0,Italy,7,7,0,Italy,Georgia,1855,1126,729,-729
2210,2016-06-07,Czech Republic,3,Northern Ireland,0,3,0,Czech Republic,Northern Ireland,1647,1386,261,-261
2211,2016-06-07,Serbia,0,England,7,7,0,England,Serbia,2033,1532,501,-501
2212,2016-06-07,Wales,0,Norway,2,2,0,Norway,Wales,1923,1604,319,-319
2213,2016-07-09,USA,1,South Africa,0,1,0,USA,South Africa,2168,1442,726,-726
2214,2016-07-23,USA,4,Costa Rica,0,4,0,USA,Costa Rica,2168,1658,510,-510
2215,2016-08-03,Northern Ireland,1,Czech Republic,1,1,1,Northern Ireland,Czech Republic,1388,1638,-250,250
2216,2016-08-03,Sweden,1,South Africa,0,1,0,Sweden,South Africa,2002,1442,560,-560
2217,2016-08-03,Brazil,3,China PR,0,3,0,Brazil,China PR,1982,1914,68,-68
2218,2016-08-03,Canada,2,Australia,0,2,0,Canada,Australia,1938,2011,-73,73
2219,2016-08-03,Zimbabwe,1,Germany,6,6,1,Germany,Zimbabwe,2115,1208,907,-907
2220,2016-08-03,USA,2,New Zealand,0,2,0,USA,New Zealand,2168,1848,320,-320
2221,2016-08-03,France,4,Colombia,0,4,0,France,Colombia,2064,1748,316,-316
2222,2016-08-06,South Africa,0,China PR,2,2,0,China PR,South Africa,1914,1442,472,-472
2223,2016-08-06,Brazil,5,Sweden,1,5,1,Brazil,Sweden,1982,2002,-20,20
2224,2016-08-06,Canada,3,Zimbabwe,1,3,1,Canada,Zimbabwe,1938,1208,730,-730
2225,2016-08-06,Germany,2,Australia,2,2,2,Germany,Australia,2115,2011,104,-104
2226,2016-08-06,USA,1,France,0,1,0,USA,France,2168,2064,104,-104
2227,2016-08-06,Colombia,0,New Zealand,1,1,0,New Zealand,Colombia,1848,1748,100,-100
2228,2016-08-09,Brazil,0,South Africa,0,0,0,Brazil,South Africa,1982,1442,540,-540
2229,2016-08-09,China PR,0,Sweden,0,0,0,China PR,Sweden,1914,2002,-88,88
2230,2016-08-09,Germany,1,Canada,2,2,1,Canada,Germany,1938,2115,-177,177
2231,2016-08-09,Australia,6,Zimbabwe,1,6,1,Australia,Zimbabwe,2011,1208,803,-803
2232,2016-08-09,Colombia,2,USA,2,2,2,Colombia,USA,1748,2168,-420,420
2233,2016-08-09,New Zealand,0,France,3,3,0,France,New Zealand,2064,1848,216,-216
2234,2016-08-12,USA,1,Sweden,1,1,1,USA,Sweden,2168,2002,166,-166
2235,2016-08-12,China PR,0,Germany,1,1,0,Germany,China PR,2115,1914,201,-201
2236,2016-08-12,Canada,1,France,0,1,0,Canada,France,1938,2064,-126,126
2237,2016-08-12,Brazil,0,Australia,0,0,0,Brazil,Australia,1982,2011,-29,29
2238,2016-08-16,Brazil,0,Sweden,0,0,0,Brazil,Sweden,1982,2002,-20,20
2239,2016-08-16,Canada,0,Germany,2,2,0,Germany,Canada,2115,1938,177,-177
2240,2016-08-19,Brazil,1,Canada,2,2,1,Canada,Brazil,1938,1982,-44,44
2241,2016-08-19,Sweden,1,Germany,2,2,1,Germany,Sweden,2115,2002,113,-113
2242,2016-09-15,Belarus,6,FYR Macedonia,2,6,2,Belarus,FYR Macedonia,1456,1069,387,-387
2243,2016-09-15,Spain,13,Montenegro,0,13,0,Spain,Montenegro,1861,1225,636,-636
2244,2016-09-15,Romania,2,Ukraine,1,2,1,Romania,Ukraine,1593,1757,-164,164
2245,2016-09-15,Sweden,2,Slovakia,1,2,1,Sweden,Slovakia,1995,1541,454,-454
2246,2016-09-15,Moldova,0,Denmark,5,5,0,Denmark,Moldova,1838,1174,664,-664
2247,2016-09-15,Georgia,0,Switzerland,3,3,0,Switzerland,Georgia,1850,1141,709,-709
2248,2016-09-15,Serbia,1,Belgium,3,3,1,Belgium,Serbia,1737,1529,208,-208
2249,2016-09-15,England,5,Estonia,0,5,0,England,Estonia,2021,1266,755,-755
2250,2016-09-15,Norway,10,Kazakhstan,0,10,0,Norway,Kazakhstan,1923,1355,568,-568
2251,2016-09-15,Wales,3,Israel,0,3,0,Wales,Israel,1605,1414,191,-191
2252,2016-09-16,USA,9,Thailand,0,9,0,USA,Thailand,2137,1634,503,-503
2253,2016-09-16,Iceland,4,Slovenia,0,4,0,Iceland,Slovenia,1849,1405,444,-444
2254,2016-09-16,Portugal,3,Finland,2,3,2,Portugal,Finland,1565,1726,-161,161
2255,2016-09-16,Russia,0,Germany,4,4,0,Germany,Russia,2112,1762,350,-350
2256,2016-09-16,Northern Ireland,0,Italy,3,3,0,Italy,Northern Ireland,1847,1394,453,-453
2257,2016-09-19,USA,3,Netherlands,1,3,1,USA,Netherlands,2137,1902,235,-235
2258,2016-09-19,Norway,5,Israel,0,5,0,Norway,Israel,1923,1414,509,-509
2259,2016-09-20,Belarus,2,Slovenia,0,2,0,Belarus,Slovenia,1456,1405,51,-51
2260,2016-09-20,Iceland,1,Scotland,2,2,1,Scotland,Iceland,1778,1849,-71,71
2261,2016-09-20,Spain,5,Finland,0,5,0,Spain,Finland,1861,1726,135,-135
2262,2016-09-20,Republic of Ireland,0,Portugal,1,1,0,Portugal,Republic of Ireland,1565,1640,-75,75
2263,2016-09-20,Romania,4,Greece,0,4,0,Romania,Greece,1593,1378,215,-215
2264,2016-09-20,France,6,Albania,0,6,0,France,Albania,2046,1292,754,-754
2265,2016-09-20,Poland,4,Moldova,0,4,0,Poland,Moldova,1636,1174,462,-462
2266,2016-09-20,Denmark,2,Sweden,0,2,0,Denmark,Sweden,1838,1995,-157,157
2267,2016-09-20,Hungary,0,Germany,1,1,0,Germany,Hungary,2112,1566,546,-546
2268,2016-09-20,Russia,5,Croatia,0,5,0,Russia,Croatia,1762,1427,335,-335
2269,2016-09-20,Switzerland,4,Northern Ireland,0,4,0,Switzerland,Northern Ireland,1850,1394,456,-456
2270,2016-09-20,Italy,3,Czech Republic,1,3,1,Italy,Czech Republic,1847,1632,215,-215
2271,2016-09-20,Bosnia and Herzegovina,2,Serbia,4,4,2,Serbia,Bosnia and Herzegovina,1529,1403,126,-126
2272,2016-09-20,Belgium,0,England,2,2,0,England,Belgium,2021,1737,284,-284
2273,2016-09-20,Wales,0,Austria,0,0,0,Wales,Austria,1605,1747,-142,142
2274,2016-10-20,USA,4,Switzerland,0,4,0,USA,Switzerland,2137,1850,287,-287
2275,2016-10-21,Portugal,0,Romania,0,0,0,Portugal,Romania,1565,1593,-28,28
2276,2016-10-23,USA,5,Switzerland,1,5,1,USA,Switzerland,2137,1850,287,-287
2277,2016-10-25,Romania,1,Portugal,1,1,1,Romania,Portugal,1593,1565,28,-28
2278,2016-11-11,USA,8,Romania,1,8,1,USA,Romania,2137,1593,544,-544
2279,2016-11-14,USA,5,Romania,0,5,0,USA,Romania,2137,1593,544,-544
2280,2016-11-19,Cameroon,2,Egypt,0,2,0,Cameroon,Egypt,1484,1287,197,-197
2281,2016-11-19,South Africa,0,Zimbabwe,0,0,0,South Africa,Zimbabwe,1478,1215,263,-263
2282,2016-11-20,Nigeria,6,Mali,0,6,0,Nigeria,Mali,1592,1222,370,-370
2283,2016-11-20,Ghana,3,Kenya,1,3,1,Ghana,Kenya,1487,822,665,-665
2284,2016-11-22,Cameroon,1,South Africa,0,1,0,Cameroon,South Africa,1484,1478,6,-6
2285,2016-11-22,Zimbabwe,0,Egypt,1,1,0,Egypt,Zimbabwe,1287,1215,72,-72
2286,2016-11-23,Nigeria,1,Ghana,1,1,1,Nigeria,Ghana,1592,1487,105,-105
2287,2016-11-23,Kenya,1,Mali,3,3,1,Mali,Kenya,1222,822,400,-400
2288,2016-11-25,Cameroon,2,Zimbabwe,0,2,0,Cameroon,Zimbabwe,1484,1215,269,-269
2289,2016-11-25,Egypt,0,South Africa,5,5,0,South Africa,Egypt,1478,1287,191,-191
2290,2016-11-26,Kenya,0,Nigeria,4,4,0,Nigeria,Kenya,1592,822,770,-770
2291,2016-11-26,Mali,1,Ghana,3,3,1,Ghana,Mali,1487,1222,265,-265
2292,2016-11-29,Cameroon,1,Ghana,0,1,0,Cameroon,Ghana,1484,1487,-3,3
2293,2016-11-29,Nigeria,1,South Africa,0,1,0,Nigeria,South Africa,1592,1478,114,-114
2294,2016-12-02,Ghana,1,South Africa,0,1,0,Ghana,South Africa,1487,1478,9,-9
2295,2016-12-03,Cameroon,0,Nigeria,1,1,0,Nigeria,Cameroon,1592,1484,108,-108
2296,2017-01-19,Myanmar,0,Ukraine,4,4,0,Ukraine,Myanmar,1732,1531,201,-201
2297,2017-01-19,China PR,2,Thailand,0,2,0,China PR,Thailand,1892,1642,250,-250
2298,2017-01-21,China PR,2,Myanmar,0,2,0,China PR,Myanmar,1892,1531,361,-361
2299,2017-01-21,Ukraine,0,Thailand,1,1,0,Thailand,Ukraine,1642,1732,-90,90
2300,2017-01-24,Thailand,3,Myanmar,0,3,0,Thailand,Myanmar,1642,1531,111,-111
2301,2017-01-24,China PR,5,Ukraine,0,5,0,China PR,Ukraine,1892,1732,160,-160
2302,2017-03-01,Portugal,0,Russia,1,1,0,Russia,Portugal,1750,1595,155,-155
2303,2017-03-01,Denmark,0,Canada,1,1,0,Canada,Denmark,2031,1861,170,-170
2304,2017-03-01,Japan,1,Spain,2,2,1,Spain,Japan,1862,1982,-120,120
2305,2017-03-01,Norway,1,Iceland,1,1,1,Norway,Iceland,1927,1831,96,-96
2306,2017-03-01,Netherlands,1,China PR,0,1,0,Netherlands,China PR,1903,1892,11,-11
2307,2017-03-01,Australia,0,Sweden,1,1,0,Sweden,Australia,1977,1984,-7,7
2308,2017-03-01,England,1,France,2,2,1,France,England,2041,2030,11,-11
2309,2017-03-01,USA,1,Germany,0,1,0,USA,Germany,2140,2109,31,-31
2310,2017-03-01,Korea DPR,3,Italy,0,3,0,Korea DPR,Italy,1952,1854,98,-98
2311,2017-03-01,Belgium,2,Switzerland,2,2,2,Belgium,Switzerland,1743,1848,-105,105
2312,2017-03-01,New Zealand,2,Scotland,3,3,2,Scotland,New Zealand,1788,1846,-58,58
2313,2017-03-01,Korea Republic,0,Austria,0,0,0,Korea Republic,Austria,1847,1745,102,-102
2314,2017-03-01,Czech Republic,0,Republic of Ireland,2,2,0,Republic of Ireland,Czech Republic,1623,1626,-3,3
2315,2017-03-01,Hungary,0,Wales,2,2,0,Wales,Hungary,1609,1582,27,-27
2316,2017-03-03,Russia,1,Canada,2,2,1,Canada,Russia,2031,1750,281,-281
2317,2017-03-03,Portugal,0,Denmark,6,6,0,Denmark,Portugal,1861,1595,266,-266
2318,2017-03-03,Japan,2,Iceland,0,2,0,Japan,Iceland,1982,1831,151,-151
2319,2017-03-03,Spain,3,Norway,0,3,0,Spain,Norway,1862,1927,-65,65
2320,2017-03-03,Australia,3,Netherlands,2,3,2,Australia,Netherlands,1984,1903,81,-81
2321,2017-03-03,China PR,0,Sweden,0,0,0,China PR,Sweden,1892,1977,-85,85
2322,2017-03-03,Switzerland,1,Korea DPR,0,1,0,Switzerland,Korea DPR,1848,1952,-104,104
2323,2017-03-03,Italy,1,Belgium,4,4,1,Belgium,Italy,1743,1854,-111,111
2324,2017-03-03,Austria,3,New Zealand,0,3,0,Austria,New Zealand,1745,1846,-101,101
2325,2017-03-03,Scotland,0,Korea Republic,2,2,0,Korea Republic,Scotland,1847,1788,59,-59
2326,2017-03-03,Wales,0,Czech Republic,0,0,0,Wales,Czech Republic,1609,1626,-17,17
2327,2017-03-03,Republic of Ireland,0,Hungary,0,0,0,Republic of Ireland,Hungary,1623,1582,41,-41
2328,2017-03-04,France,0,Germany,0,0,0,France,Germany,2041,2109,-68,68
2329,2017-03-04,USA,0,England,1,1,0,England,USA,2030,2140,-110,110
2330,2017-03-06,Russia,1,Denmark,6,6,1,Denmark,Russia,1861,1750,111,-111
2331,2017-03-06,Portugal,0,Canada,0,0,0,Portugal,Canada,1595,2031,-436,436
2332,2017-03-06,Norway,0,Japan,2,2,0,Japan,Norway,1982,1927,55,-55
2333,2017-03-06,Iceland,0,Spain,0,0,0,Iceland,Spain,1831,1862,-31,31
2334,2017-03-06,China PR,1,Australia,2,2,1,Australia,China PR,1984,1892,92,-92
2335,2017-03-06,Sweden,0,Netherlands,1,1,0,Netherlands,Sweden,1903,1977,-74,74
2336,2017-03-06,Italy,0,Switzerland,6,6,0,Switzerland,Italy,1848,1854,-6,6
2337,2017-03-06,Korea DPR,4,Belgium,1,4,1,Korea DPR,Belgium,1952,1743,209,-209
2338,2017-03-06,Austria,1,Scotland,3,3,1,Scotland,Austria,1788,1745,43,-43
2339,2017-03-06,New Zealand,0,Korea Republic,2,2,0,Korea Republic,New Zealand,1847,1846,1,-1
2340,2017-03-06,Republic of Ireland,1,Wales,0,1,0,Republic of Ireland,Wales,1623,1609,14,-14
2341,2017-03-06,Czech Republic,1,Hungary,2,2,1,Hungary,Czech Republic,1582,1626,-44,44
2342,2017-03-07,Germany,1,England,0,1,0,Germany,England,2109,2030,79,-79
2343,2017-03-07,USA,0,France,3,3,0,France,USA,2041,2140,-99,99
2344,2017-03-08,Portugal,0,Norway,2,2,0,Norway,Portugal,1927,1595,332,-332
2345,2017-03-08,Iceland,2,China PR,1,2,1,Iceland,China PR,1831,1892,-61,61
2346,2017-03-08,Sweden,4,Russia,0,4,0,Sweden,Russia,1977,1750,227,-227
2347,2017-03-08,Japan,2,Netherlands,3,3,2,Netherlands,Japan,1903,1982,-79,79
2348,2017-03-08,Australia,1,Denmark,1,1,1,Australia,Denmark,1984,1861,123,-123
2349,2017-03-08,Spain,1,Canada,0,1,0,Spain,Canada,1862,2031,-169,169
2350,2017-03-08,Italy,6,Czech Republic,2,6,2,Italy,Czech Republic,1854,1626,228,-228
2351,2017-03-08,New Zealand,3,Hungary,1,3,1,New Zealand,Hungary,1846,1582,264,-264
2352,2017-03-08,Belgium,1,Austria,1,1,1,Belgium,Austria,1743,1745,-2,2
2353,2017-03-08,Scotland,0,Wales,0,0,0,Scotland,Wales,1788,1609,179,-179
2354,2017-03-08,Korea DPR,2,Republic of Ireland,0,2,0,Korea DPR,Republic of Ireland,1952,1623,329,-329
2355,2017-03-08,Switzerland,1,Korea Republic,0,1,0,Switzerland,Korea Republic,1848,1847,1,-1
2356,2017-04-03,Bahrain,0,Jordan,6,6,0,Jordan,Bahrain,1423,1288,135,-135
2357,2017-04-03,Tajikistan,1,Iraq,0,1,0,Tajikistan,Iraq,0,882,-882,882
2358,2017-04-03,Philippines,4,United Arab Emirates,0,4,0,Philippines,United Arab Emirates,1312,1265,47,-47
2359,2017-04-03,Korea DPR,8,India,0,8,0,Korea DPR,India,1953,1404,549,-549
2360,2017-04-03,Hong Kong,1,Uzbekistan,2,2,1,Uzbekistan,Hong Kong,1548,1344,204,-204
2361,2017-04-03,Palestine,0,Thailand,6,6,0,Thailand,Palestine,1652,1192,460,-460
2362,2017-04-03,IR Iran,0,Myanmar,2,2,0,Myanmar,IR Iran,1524,1418,106,-106
2363,2017-04-03,Singapore,1,Syria,0,1,0,Singapore,Syria,1147,927,220,-220
2364,2017-04-05,Philippines,4,Iraq,0,4,0,Philippines,Iraq,1312,882,430,-430
2365,2017-04-05,Tajikistan,0,Bahrain,4,4,0,Bahrain,Tajikistan,1288,0,1288,-1288
2366,2017-04-05,Jordan,6,United Arab Emirates,0,6,0,Jordan,United Arab Emirates,1423,1265,158,-158
2367,2017-04-05,Korea DPR,5,Hong Kong,0,5,0,Korea DPR,Hong Kong,1953,1344,609,-609
2368,2017-04-05,India,0,Korea Republic,10,10,0,Korea Republic,India,1850,1404,446,-446
2369,2017-04-05,Palestine,0,Chinese Taipei,5,5,0,Chinese Taipei,Palestine,1559,1192,367,-367
2370,2017-04-05,Singapore,0,IR Iran,6,6,0,IR Iran,Singapore,1418,1147,271,-271
2371,2017-04-05,Vietnam,11,Syria,0,11,0,Vietnam,Syria,1630,927,703,-703
2372,2017-04-06,Estonia,0,Latvia,4,4,0,Latvia,Estonia,1171,1266,-95,95
2373,2017-04-06,Georgia,0,Kazakhstan,1,1,0,Kazakhstan,Georgia,1355,1140,215,-215
2374,2017-04-06,Albania,3,Kosovo,2,3,2,Albania,Kosovo,1295,1168,127,-127
2375,2017-04-06,Greece,1,Malta,0,1,0,Greece,Malta,1376,1171,205,-205
2376,2017-04-06,Moldova,4,Andorra,0,4,0,Moldova,Andorra,1174,749,425,-425
2377,2017-04-06,Lithuania,0,Israel,2,2,0,Israel,Lithuania,1410,1224,186,-186
2378,2017-04-06,Turkey,3,Montenegro,0,3,0,Turkey,Montenegro,1407,1222,185,-185
2379,2017-04-06,Faroe Islands,5,Luxembourg,1,5,1,Faroe Islands,Luxembourg,1289,1158,131,-131
2380,2017-04-07,USA,4,Russia,0,4,0,USA,Russia,2105,1736,369,-369
2381,2017-04-07,United Arab Emirates,1,Bahrain,1,1,1,United Arab Emirates,Bahrain,1265,1288,-23,23
2382,2017-04-07,Tajikistan,0,Philippines,8,8,0,Philippines,Tajikistan,1312,0,1312,-1312
2383,2017-04-07,Jordan,10,Iraq,0,10,0,Jordan,Iraq,1423,882,541,-541
2384,2017-04-07,Korea DPR,1,Korea Republic,1,1,1,Korea DPR,Korea Republic,1953,1850,103,-103
2385,2017-04-07,Uzbekistan,7,India,1,7,1,Uzbekistan,India,1548,1404,144,-144
2386,2017-04-07,Thailand,1,Chinese Taipei,0,1,0,Thailand,Chinese Taipei,1652,1559,93,-93
2387,2017-04-07,Myanmar,14,Syria,0,14,0,Myanmar,Syria,1524,927,597,-597
2388,2017-04-07,Vietnam,8,Singapore,0,8,0,Vietnam,Singapore,1630,1147,483,-483
2389,2017-04-08,Kazakhstan,2,Latvia,2,2,2,Kazakhstan,Latvia,1355,1171,184,-184
2390,2017-04-08,Georgia,2,Estonia,1,2,1,Georgia,Estonia,1140,1266,-126,126
2391,2017-04-08,Greece,6,Kosovo,0,6,0,Greece,Kosovo,1376,1168,208,-208
2392,2017-04-08,Albania,0,Malta,0,0,0,Albania,Malta,1295,1171,124,-124
2393,2017-04-08,Lithuania,0,Moldova,2,2,0,Moldova,Lithuania,1174,1224,-50,50
2394,2017-04-08,Israel,7,Andorra,0,7,0,Israel,Andorra,1410,749,661,-661
2395,2017-04-08,Faroe Islands,2,Montenegro,1,2,1,Faroe Islands,Montenegro,1289,1222,67,-67
2396,2017-04-08,Turkey,9,Luxembourg,1,9,1,Turkey,Luxembourg,1407,1158,249,-249
2397,2017-04-09,USA,5,Russia,1,5,1,USA,Russia,2105,1736,369,-369
2398,2017-04-09,Korea DPR,4,Uzbekistan,0,4,0,Korea DPR,Uzbekistan,1953,1548,405,-405
2399,2017-04-09,Hong Kong,0,Korea Republic,6,6,0,Korea Republic,Hong Kong,1850,1344,506,-506
2400,2017-04-09,Myanmar,6,Singapore,0,6,0,Myanmar,Singapore,1524,1147,377,-377
2401,2017-04-09,Vietnam,6,IR Iran,1,6,1,Vietnam,IR Iran,1630,1418,212,-212
2402,2017-04-10,Iraq,0,United Arab Emirates,3,3,0,United Arab Emirates,Iraq,1265,882,383,-383
2403,2017-04-10,Tajikistan,2,Jordan,10,10,2,Jordan,Tajikistan,1423,0,1423,-1423
2404,2017-04-10,Philippines,1,Bahrain,1,1,1,Philippines,Bahrain,1312,1288,24,-24
2405,2017-04-11,Estonia,0,Kazakhstan,1,1,0,Kazakhstan,Estonia,1355,1266,89,-89
2406,2017-04-11,Georgia,1,Latvia,1,1,1,Georgia,Latvia,1140,1171,-31,31
2407,2017-04-11,Albania,2,Greece,1,2,1,Albania,Greece,1295,1376,-81,81
2408,2017-04-11,Kosovo,1,Malta,3,3,1,Malta,Kosovo,1171,1168,3,-3
2409,2017-04-11,Moldova,0,Israel,0,0,0,Moldova,Israel,1174,1410,-236,236
2410,2017-04-11,Lithuania,2,Andorra,0,2,0,Lithuania,Andorra,1224,749,475,-475
2411,2017-04-11,Faroe Islands,2,Turkey,1,2,1,Faroe Islands,Turkey,1289,1407,-118,118
2412,2017-04-11,Luxembourg,1,Montenegro,7,7,1,Montenegro,Luxembourg,1222,1158,64,-64
2413,2017-04-11,India,2,Hong Kong,0,2,0,India,Hong Kong,1404,1344,60,-60
2414,2017-04-11,Korea Republic,4,Uzbekistan,0,4,0,Korea Republic,Uzbekistan,1850,1548,302,-302
2415,2017-04-11,Syria,0,IR Iran,12,12,0,IR Iran,Syria,1418,927,491,-491
2416,2017-04-11,Vietnam,2,Myanmar,0,2,0,Vietnam,Myanmar,1630,1524,106,-106
2417,2017-04-12,Jordan,5,Philippines,1,5,1,Jordan,Philippines,1423,1312,111,-111
2418,2017-04-12,Tajikistan,0,United Arab Emirates,1,1,0,United Arab Emirates,Tajikistan,1265,0,1265,-1265
2419,2017-04-12,Bahrain,4,Iraq,0,4,0,Bahrain,Iraq,1288,882,406,-406
2420,2017-06-08,Sweden,0,USA,1,1,0,USA,Sweden,2105,1977,128,-128
2421,2017-06-11,Norway,0,USA,1,1,0,USA,Norway,2105,1926,179,-179
2422,2017-07-16,Netherlands,1,Norway,0,1,0,Netherlands,Norway,1918,1924,-6,6
2423,2017-07-16,Denmark,1,Belgium,0,1,0,Denmark,Belgium,1872,1756,116,-116
2424,2017-07-17,Italy,1,Russia,2,2,1,Russia,Italy,1738,1841,-103,103
2425,2017-07-17,Germany,0,Sweden,0,0,0,Germany,Sweden,2111,1956,155,-155
2426,2017-07-18,Austria,1,Switzerland,0,1,0,Austria,Switzerland,1746,1858,-112,112
2427,2017-07-18,France,1,Iceland,0,1,0,France,Iceland,2076,1829,247,-247
2428,2017-07-19,Spain,2,Portugal,0,2,0,Spain,Portugal,1885,1590,295,-295
2429,2017-07-19,England,6,Scotland,0,6,0,England,Scotland,2024,1788,236,-236
2430,2017-07-20,Norway,0,Belgium,2,2,0,Belgium,Norway,1756,1924,-168,168
2431,2017-07-20,Netherlands,1,Denmark,0,1,0,Netherlands,Denmark,1918,1872,46,-46
2432,2017-07-21,Sweden,2,Russia,0,2,0,Sweden,Russia,1956,1738,218,-218
2433,2017-07-21,Germany,2,Italy,1,2,1,Germany,Italy,2111,1841,270,-270
2434,2017-07-22,Iceland,1,Switzerland,2,2,1,Switzerland,Iceland,1858,1829,29,-29
2435,2017-07-22,France,1,Austria,1,1,1,France,Austria,2076,1746,330,-330
2436,2017-07-23,Scotland,1,Portugal,2,2,1,Portugal,Scotland,1590,1788,-198,198
2437,2017-07-23,England,2,Spain,0,2,0,England,Spain,2024,1885,139,-139
2438,2017-07-24,Netherlands,2,Belgium,1,2,1,Netherlands,Belgium,1918,1756,162,-162
2439,2017-07-24,Norway,0,Denmark,1,1,0,Denmark,Norway,1872,1924,-52,52
2440,2017-07-25,Russia,0,Germany,2,2,0,Germany,Russia,2111,1738,373,-373
2441,2017-07-25,Sweden,2,Italy,3,3,2,Italy,Sweden,1841,1956,-115,115
2442,2017-07-26,Switzerland,1,France,1,1,1,Switzerland,France,1858,2076,-218,218
2443,2017-07-26,Iceland,0,Austria,3,3,0,Austria,Iceland,1746,1829,-83,83
2444,2017-07-27,Portugal,1,England,2,2,1,England,Portugal,2024,1590,434,-434
2445,2017-07-27,Scotland,1,Spain,0,1,0,Scotland,Spain,1788,1885,-97,97
2446,2017-07-27,Brazil,1,Japan,1,1,1,Brazil,Japan,1971,1981,-10,10
2447,2017-07-27,USA,0,Australia,1,1,0,Australia,USA,1976,2118,-142,142
2448,2017-07-29,Netherlands,2,Sweden,0,2,0,Netherlands,Sweden,1918,1956,-38,38
2449,2017-07-30,Germany,1,Denmark,2,2,1,Denmark,Germany,1872,2111,-239,239
2450,2017-07-30,Austria,0,Spain,0,0,0,Austria,Spain,1746,1885,-139,139
2451,2017-07-30,England,1,France,0,1,0,England,France,2024,2076,-52,52
2452,2017-07-30,Japan,2,Australia,4,4,2,Australia,Japan,1976,1981,-5,5
2453,2017-07-30,USA,4,Brazil,3,4,3,USA,Brazil,2118,1971,147,-147
2454,2017-08-03,Denmark,0,Austria,0,0,0,Denmark,Austria,1872,1746,126,-126
2455,2017-08-03,Netherlands,3,England,0,3,0,Netherlands,England,1918,2024,-106,106
2456,2017-08-03,Australia,6,Brazil,1,6,1,Australia,Brazil,1976,1971,5,-5
2457,2017-08-03,USA,3,Japan,0,3,0,USA,Japan,2118,1981,137,-137
2458,2017-08-06,Netherlands,4,Denmark,2,4,2,Netherlands,Denmark,1918,1872,46,-46
2459,2017-09-14,Faroe Islands,0,Czech Republic,8,8,0,Czech Republic,Faroe Islands,1610,1318,292,-292
2460,2017-09-15,Albania,1,Switzerland,4,4,1,Switzerland,Albania,1862,1296,566,-566
2461,2017-09-15,Poland,4,Belarus,1,4,1,Poland,Belarus,1657,1456,201,-201
2462,2017-09-15,Norway,4,Northern Ireland,1,4,1,Norway,Northern Ireland,1872,1404,468,-468
2463,2017-09-15,Ukraine,1,Croatia,1,1,1,Ukraine,Croatia,1718,1428,290,-290
2464,2017-09-15,Italy,5,Moldova,0,5,0,Italy,Moldova,1843,1215,628,-628
2465,2017-09-16,USA,3,New Zealand,1,3,1,USA,New Zealand,2104,1827,277,-277
2466,2017-09-16,Germany,6,Slovenia,0,6,0,Germany,Slovenia,2077,1408,669,-669
2467,2017-09-17,Kazakhstan,0,Wales,1,1,0,Wales,Kazakhstan,1611,1355,256,-256
2468,2017-09-18,Iceland,8,Faroe Islands,0,8,0,Iceland,Faroe Islands,1790,1318,472,-472
2469,2017-09-19,England,6,Russia,0,6,0,England,Russia,2037,1748,289,-289
2470,2017-09-19,Belarus,1,Albania,0,1,0,Belarus,Albania,1456,1296,160,-160
2471,2017-09-19,Switzerland,2,Poland,1,2,1,Switzerland,Poland,1862,1657,205,-205
2472,2017-09-19,Norway,6,Slovakia,1,6,1,Norway,Slovakia,1872,1549,323,-323
2473,2017-09-19,Northern Ireland,0,Republic of Ireland,2,2,0,Republic of Ireland,Northern Ireland,1634,1404,230,-230
2474,2017-09-19,Hungary,1,Denmark,6,6,1,Denmark,Hungary,1899,1578,321,-321
2475,2017-09-19,Croatia,0,Sweden,2,2,0,Sweden,Croatia,1934,1428,506,-506
2476,2017-09-19,Czech Republic,0,Germany,1,1,0,Germany,Czech Republic,2077,1610,467,-467
2477,2017-09-19,Romania,0,Italy,1,1,0,Italy,Romania,1843,1596,247,-247
2478,2017-09-19,Belgium,12,Moldova,0,12,0,Belgium,Moldova,1776,1215,561,-561
2479,2017-09-19,Serbia,0,Austria,4,4,0,Austria,Serbia,1819,1543,276,-276
2480,2017-09-20,USA,5,New Zealand,0,5,0,USA,New Zealand,2104,1827,277,-277
2481,2017-10-19,Belarus,1,Scotland,2,2,1,Scotland,Belarus,1777,1456,321,-321
2482,2017-10-19,Hungary,2,Croatia,2,2,2,Hungary,Croatia,1578,1428,150,-150
2483,2017-10-19,Serbia,2,Israel,0,2,0,Serbia,Israel,1543,1410,133,-133
2484,2017-10-20,USA,3,Korea Republic,1,3,1,USA,Korea Republic,2104,1871,233,-233
2485,2017-10-20,Sweden,3,Denmark,0,3,0,Sweden,Denmark,1934,1899,35,-35
2486,2017-10-20,Germany,2,Iceland,3,3,2,Iceland,Germany,1790,2077,-287,287
2487,2017-10-20,Slovenia,0,Czech Republic,4,4,0,Czech Republic,Slovenia,1610,1408,202,-202
2488,2017-10-20,Belgium,3,Romania,2,3,2,Belgium,Romania,1776,1596,180,-180
2489,2017-10-21,Kazakhstan,0,Bosnia and Herzegovina,2,2,0,Bosnia and Herzegovina,Kazakhstan,1392,1355,37,-37
2490,2017-10-22,USA,6,Korea Republic,0,6,0,USA,Korea Republic,2104,1871,233,-233
2491,2017-10-22,Finland,1,Serbia,0,1,0,Finland,Serbia,1704,1543,161,-161
2492,2017-10-23,Israel,0,Spain,6,6,0,Spain,Israel,1849,1410,439,-439
2493,2017-10-24,Russia,0,Wales,0,0,0,Russia,Wales,1748,1611,137,-137
2494,2017-10-24,Scotland,5,Albania,0,5,0,Scotland,Albania,1777,1296,481,-481
2495,2017-10-24,Slovakia,0,Republic of Ireland,2,2,0,Republic of Ireland,Slovakia,1634,1549,85,-85
2496,2017-10-24,Netherlands,1,Norway,0,1,0,Netherlands,Norway,1979,1872,107,-107
2497,2017-10-24,Croatia,0,Denmark,4,4,0,Denmark,Croatia,1899,1428,471,-471
2498,2017-10-24,Sweden,5,Hungary,0,5,0,Sweden,Hungary,1934,1578,356,-356
2499,2017-10-24,Germany,11,Faroe Islands,0,11,0,Germany,Faroe Islands,2077,1318,759,-759
2500,2017-10-24,Czech Republic,1,Iceland,1,1,1,Czech Republic,Iceland,1610,1790,-180,180
2501,2017-10-24,Italy,3,Romania,0,3,0,Italy,Romania,1843,1596,247,-247
2502,2017-10-24,Portugal,0,Belgium,1,1,0,Belgium,Portugal,1776,1617,159,-159
2503,2017-11-10,Canada,1,USA,1,1,1,Canada,USA,2027,2104,-77,77
2504,2017-11-13,USA,3,Canada,1,3,1,USA,Canada,2104,2027,77,-77
2505,2017-11-23,Austria,2,Israel,0,2,0,Austria,Israel,1819,1410,409,-409
2506,2017-11-24,Wales,1,Kazakhstan,0,1,0,Wales,Kazakhstan,1611,1355,256,-256
2507,2017-11-24,England,4,Bosnia and Herzegovina,0,4,0,England,Bosnia and Herzegovina,2037,1392,645,-645
2508,2017-11-24,Albania,1,Poland,4,4,1,Poland,Albania,1657,1296,361,-361
2509,2017-11-24,Switzerland,3,Belarus,0,3,0,Switzerland,Belarus,1862,1456,406,-406
2510,2017-11-24,Slovakia,0,Netherlands,5,5,0,Netherlands,Slovakia,1979,1549,430,-430
2511,2017-11-24,Hungary,0,Ukraine,1,1,0,Ukraine,Hungary,1718,1578,140,-140
2512,2017-11-24,Slovenia,5,Faroe Islands,0,5,0,Slovenia,Faroe Islands,1408,1318,90,-90
2513,2017-11-24,Portugal,8,Moldova,0,8,0,Portugal,Moldova,1617,1215,402,-402
2514,2017-11-24,Serbia,1,Spain,2,2,1,Spain,Serbia,1849,1543,306,-306
2515,2017-11-26,Finland,4,Israel,0,4,0,Finland,Israel,1704,1410,294,-294
2516,2017-11-28,Bosnia and Herzegovina,0,Wales,1,1,0,Wales,Bosnia and Herzegovina,1611,1392,219,-219
2517,2017-11-28,England,5,Kazakhstan,0,5,0,England,Kazakhstan,2037,1355,682,-682
2518,2017-11-28,Switzerland,5,Albania,1,5,1,Switzerland,Albania,1862,1296,566,-566
2519,2017-11-28,Slovakia,1,Northern Ireland,3,3,1,Northern Ireland,Slovakia,1404,1549,-145,145
2520,2017-11-28,Netherlands,0,Republic of Ireland,0,0,0,Netherlands,Republic of Ireland,1979,1634,345,-345
2521,2017-11-28,Romania,3,Moldova,1,3,1,Romania,Moldova,1596,1215,381,-381
2522,2017-11-28,Portugal,0,Italy,1,1,0,Italy,Portugal,1843,1617,226,-226
2523,2017-11-28,Spain,4,Austria,0,4,0,Spain,Austria,1849,1819,30,-30
2524,2018-01-19,Colombia,1,Thailand,1,1,1,Colombia,Thailand,1756,1668,88,-88
2525,2018-01-19,China PR,4,Vietnam,0,4,0,China PR,Vietnam,1861,1652,209,-209
2526,2018-01-21,China PR,2,Thailand,1,2,1,China PR,Thailand,1861,1668,193,-193
2527,2018-01-21,Vietnam,0,Colombia,2,2,0,Colombia,Vietnam,1756,1652,104,-104
2528,2018-01-22,USA,5,Denmark,1,5,1,USA,Denmark,2114,1899,215,-215
2529,2018-01-22,Israel,0,Finland,0,0,0,Israel,Finland,1398,1708,-310,310
2530,2018-01-23,Thailand,2,Vietnam,0,2,0,Thailand,Vietnam,1668,1652,16,-16
2531,2018-01-23,China PR,2,Colombia,0,2,0,China PR,Colombia,1861,1756,105,-105
2532,2018-02-28,Portugal,2,China PR,1,2,1,Portugal,China PR,1600,1861,-261,261
2533,2018-02-28,Australia,4,Norway,3,4,3,Australia,Norway,2030,1868,162,-162
2534,2018-02-28,Korea Republic,3,Russia,1,3,1,Korea Republic,Russia,1868,1730,138,-138
2535,2018-02-28,Canada,1,Sweden,3,3,1,Sweden,Canada,1955,2023,-68,68
2536,2018-02-28,Japan,2,Netherlands,6,6,2,Netherlands,Japan,1972,1967,5,-5
2537,2018-02-28,Denmark,0,Iceland,0,0,0,Denmark,Iceland,1899,1818,81,-81
2538,2018-02-28,Finland,0,Wales,1,1,0,Wales,Finland,1635,1708,-73,73
2539,2018-02-28,Italy,3,Switzerland,0,3,0,Italy,Switzerland,1860,1860,0,0
2540,2018-02-28,Belgium,1,Czech Republic,2,2,1,Czech Republic,Belgium,1642,1788,-146,146
2541,2018-02-28,Austria,0,Spain,2,2,0,Spain,Austria,1869,1810,59,-59
2542,2018-02-28,Slovakia,0,South Africa,0,0,0,Slovakia,South Africa,1492,1435,57,-57
2543,2018-02-28,Hungary,0,Korea DPR,2,2,0,Korea DPR,Hungary,1948,1538,410,-410
2544,2018-03-01,England,4,France,1,4,1,England,France,2033,2019,14,-14
2545,2018-03-01,USA,1,Germany,0,1,0,USA,Germany,2114,2052,62,-62
2546,2018-03-02,Portugal,0,Australia,0,0,0,Portugal,Australia,1600,2030,-430,430
2547,2018-03-02,China PR,0,Norway,2,2,0,Norway,China PR,1868,1861,7,-7
2548,2018-03-02,Russia,0,Canada,1,1,0,Canada,Russia,2023,1730,293,-293
2549,2018-03-02,Sweden,1,Korea Republic,1,1,1,Sweden,Korea Republic,1955,1868,87,-87
2550,2018-03-02,Japan,2,Iceland,1,2,1,Japan,Iceland,1967,1818,149,-149
2551,2018-03-02,Denmark,2,Netherlands,3,3,2,Netherlands,Denmark,1972,1899,73,-73
2552,2018-03-02,Wales,0,Italy,3,3,0,Italy,Wales,1860,1635,225,-225
2553,2018-03-02,Switzerland,4,Finland,0,4,0,Switzerland,Finland,1860,1708,152,-152
2554,2018-03-02,Czech Republic,0,Austria,2,2,0,Austria,Czech Republic,1810,1642,168,-168
2555,2018-03-02,Spain,0,Belgium,0,0,0,Spain,Belgium,1869,1788,81,-81
2556,2018-03-02,Korea DPR,1,Slovakia,0,1,0,Korea DPR,Slovakia,1948,1492,456,-456
2557,2018-03-02,South Africa,1,Hungary,0,1,0,South Africa,Hungary,1435,1538,-103,103
2558,2018-03-04,USA,1,France,1,1,1,USA,France,2114,2019,95,-95
2559,2018-03-04,Germany,2,England,2,2,2,Germany,England,2052,2033,19,-19
2560,2018-03-05,Portugal,2,Norway,0,2,0,Portugal,Norway,1600,1868,-268,268
2561,2018-03-05,Australia,2,China PR,0,2,0,Australia,China PR,2030,1861,169,-169
2562,2018-03-05,Sweden,3,Russia,0,3,0,Sweden,Russia,1955,1730,225,-225
2563,2018-03-05,Korea Republic,0,Canada,3,3,0,Canada,Korea Republic,2023,1868,155,-155
2564,2018-03-05,Japan,2,Denmark,0,2,0,Japan,Denmark,1967,1899,68,-68
2565,2018-03-05,Iceland,0,Netherlands,0,0,0,Iceland,Netherlands,1818,1972,-154,154
2566,2018-03-05,Finland,2,Italy,2,2,2,Finland,Italy,1708,1860,-152,152
2567,2018-03-05,Switzerland,0,Wales,0,0,0,Switzerland,Wales,1860,1635,225,-225
2568,2018-03-05,Belgium,2,Austria,0,2,0,Belgium,Austria,1788,1810,-22,22
2569,2018-03-05,Spain,2,Czech Republic,0,2,0,Spain,Czech Republic,1869,1642,227,-227
2570,2018-03-05,South Africa,0,Korea DPR,0,0,0,South Africa,Korea DPR,1435,1948,-513,513
2571,2018-03-05,Hungary,1,Slovakia,1,1,1,Hungary,Slovakia,1538,1492,46,-46
2572,2018-03-07,China PR,2,Russia,1,2,1,China PR,Russia,1861,1730,131,-131
2573,2018-03-07,Iceland,1,Denmark,1,1,1,Iceland,Denmark,1818,1899,-81,81
2574,2018-03-07,Korea Republic,3,Norway,2,3,2,Korea Republic,Norway,1868,1868,0,0
2575,2018-03-07,Canada,2,Japan,0,2,0,Canada,Japan,2023,1967,56,-56
2576,2018-03-07,Portugal,2,Australia,1,2,1,Portugal,Australia,1600,2030,-430,430
2577,2018-03-07,France,3,Germany,0,3,0,France,Germany,2019,2052,-33,33
2578,2018-03-07,USA,1,England,0,1,0,USA,England,2114,2033,81,-81
2579,2018-03-07,Hungary,0,Finland,2,2,0,Finland,Hungary,1708,1538,170,-170
2580,2018-03-07,Slovakia,2,Czech Republic,5,5,2,Czech Republic,Slovakia,1642,1492,150,-150
2581,2018-03-07,Wales,1,Austria,1,1,1,Wales,Austria,1635,1810,-175,175
2582,2018-03-07,South Africa,1,Belgium,2,2,1,Belgium,South Africa,1788,1435,353,-353
2583,2018-03-07,Korea DPR,2,Switzerland,1,2,1,Korea DPR,Switzerland,1948,1860,88,-88
2584,2018-03-07,Italy,0,Spain,2,2,0,Spain,Italy,1869,1860,9,-9
2585,2018-04-04,Colombia,7,Uruguay,0,7,0,Colombia,Uruguay,1754,1355,399,-399
2586,2018-04-04,Chile,1,Paraguay,1,1,1,Chile,Paraguay,1567,1465,102,-102
2587,2018-04-04,Colombia,7,Uruguay,0,7,0,Colombia,Uruguay,1754,1355,399,-399
2588,2018-04-04,Chile,1,Paraguay,1,1,1,Chile,Paraguay,1567,1465,102,-102
2589,2018-04-04,Senegal,2,Algeria,1,2,1,Senegal,Algeria,1245,1283,-38,38
2590,2018-04-04,Kenya,1,Uganda,0,1,0,Kenya,Uganda,870,836,34,-34
2591,2018-04-04,Tanzania,3,Zambia,3,3,3,Tanzania,Zambia,960,1048,-88,88
2592,2018-04-05,Ecuador,0,Venezuela,1,1,0,Venezuela,Ecuador,1388,1451,-63,63
2593,2018-04-05,Brazil,3,Argentina,1,3,1,Brazil,Argentina,1968,1615,353,-353
2594,2018-04-05,Ecuador,0,Venezuela,1,1,0,Venezuela,Ecuador,1388,1451,-63,63
2595,2018-04-05,Brazil,3,Argentina,1,3,1,Brazil,Argentina,1968,1615,353,-353
2596,2018-04-05,Bosnia and Herzegovina,1,Russia,6,6,1,Russia,Bosnia and Herzegovina,1713,1409,304,-304
2597,2018-04-05,Switzerland,1,Scotland,0,1,0,Switzerland,Scotland,1849,1793,56,-56
2598,2018-04-05,Croatia,0,Ukraine,3,3,0,Ukraine,Croatia,1712,1456,256,-256
2599,2018-04-05,Hungary,1,Sweden,4,4,1,Sweden,Hungary,1963,1527,436,-436
2600,2018-04-05,Austria,1,Serbia,1,1,1,Austria,Serbia,1800,1534,266,-266
2601,2018-04-05,Namibia,0,Zimbabwe,2,2,0,Zimbabwe,Namibia,1204,1019,185,-185
2602,2018-04-06,USA,4,Mexico,1,4,1,USA,Mexico,2115,1724,391,-391
2603,2018-04-06,Paraguay,3,Peru,0,3,0,Paraguay,Peru,1465,1409,56,-56
2604,2018-04-06,Chile,1,Colombia,1,1,1,Chile,Colombia,1567,1754,-187,187
2605,2018-04-06,Paraguay,3,Peru,0,3,0,Paraguay,Peru,1465,1409,56,-56
2606,2018-04-06,Chile,1,Colombia,1,1,1,Chile,Colombia,1567,1754,-187,187
2607,2018-04-06,England,0,Wales,0,0,0,England,Wales,2042,1644,398,-398
2608,2018-04-06,Poland,1,Albania,1,1,1,Poland,Albania,1668,1293,375,-375
2609,2018-04-06,Republic of Ireland,2,Slovakia,1,2,1,Republic of Ireland,Slovakia,1684,1498,186,-186
2610,2018-04-06,Netherlands,7,Northern Ireland,0,7,0,Netherlands,Northern Ireland,1972,1425,547,-547
2611,2018-04-06,Slovenia,0,Iceland,2,2,0,Iceland,Slovenia,1819,1404,415,-415
2612,2018-04-06,Moldova,1,Italy,3,3,1,Italy,Moldova,1864,1215,649,-649
2613,2018-04-06,Belgium,1,Portugal,1,1,1,Belgium,Portugal,1788,1632,156,-156
2614,2018-04-06,Finland,0,Spain,2,2,0,Spain,Finland,1886,1691,195,-195
2615,2018-04-06,Morocco,1,Côte d'Ivoire,1,1,1,Morocco,Côte d'Ivoire,1298,1382,-84,84
2616,2018-04-06,Lesotho,1,Swaziland,0,1,0,Lesotho,Swaziland,836,832,4,-4
2617,2018-04-06,Algeria,3,Ethiopia,1,3,1,Algeria,Ethiopia,1283,1143,140,-140
2618,2018-04-06,Côte d'Ivoire,2,Mali,2,2,2,Côte d'Ivoire,Mali,1382,1222,160,-160
2619,2018-04-06,Gambia,0,Nigeria,1,1,0,Nigeria,Gambia,1608,1183,425,-425
2620,2018-04-06,Congo,0,Cameroon,5,5,0,Cameroon,Congo,1484,1206,278,-278
2621,2018-04-06,Kenya,2,Equatorial Guinea,1,2,1,Kenya,Equatorial Guinea,870,1446,-576,576
2622,2018-04-06,Lesotho,0,South Africa,1,1,0,South Africa,Lesotho,1450,836,614,-614
2623,2018-04-06,Zambia,0,Zimbabwe,1,1,0,Zimbabwe,Zambia,1204,1048,156,-156
2624,2018-04-06,China PR,4,Thailand,0,4,0,China PR,Thailand,1855,1676,179,-179
2625,2018-04-06,Jordan,1,Philippines,2,2,1,Philippines,Jordan,1316,1460,-144,144
2626,2018-04-07,Argentina,3,Bolivia,0,3,0,Argentina,Bolivia,1615,1217,398,-398
2627,2018-04-07,Ecuador,0,Brazil,8,8,0,Brazil,Ecuador,1968,1451,517,-517
2628,2018-04-07,Argentina,3,Bolivia,0,3,0,Argentina,Bolivia,1615,1217,398,-398
2629,2018-04-07,Brazil,8,Ecuador,0,8,0,Brazil,Ecuador,1968,1451,517,-517
2630,2018-04-07,Germany,4,Czech Republic,0,4,0,Germany,Czech Republic,2033,1649,384,-384
2631,2018-04-07,Burkina Faso,2,Gambia,1,2,1,Burkina Faso,Gambia,1062,1183,-121,121
2632,2018-04-07,Dominican Republic,0,Puerto Rico,0,0,0,Dominican Republic,Puerto Rico,1191,1156,35,-35
2633,2018-04-07,Japan,4,Vietnam,0,4,0,Japan,Vietnam,1950,1640,310,-310
2634,2018-04-07,Australia,0,Korea Republic,0,0,0,Australia,Korea Republic,2018,1860,158,-158
2635,2018-04-08,USA,6,Mexico,2,6,2,USA,Mexico,2115,1724,391,-391
2636,2018-04-08,Uruguay,1,Peru,1,1,1,Uruguay,Peru,1355,1409,-54,54
2637,2018-04-08,Colombia,5,Paraguay,1,5,1,Colombia,Paraguay,1754,1465,289,-289
2638,2018-04-08,Uruguay,1,Peru,1,1,1,Uruguay,Peru,1355,1409,-54,54
2639,2018-04-08,Colombia,5,Paraguay,1,5,1,Colombia,Paraguay,1754,1465,289,-289
2640,2018-04-08,Uganda,0,Kenya,0,0,0,Uganda,Kenya,836,870,-34,34
2641,2018-04-08,Zambia,1,Tanzania,1,1,1,Zambia,Tanzania,1048,960,88,-88
2642,2018-04-08,Zimbabwe,2,Namibia,0,2,0,Zimbabwe,Namibia,1204,1019,185,-185
2643,2018-04-09,Venezuela,8,Bolivia,0,8,0,Venezuela,Bolivia,1388,1217,171,-171
2644,2018-04-09,Ecuador,3,Argentina,6,6,3,Argentina,Ecuador,1615,1451,164,-164
2645,2018-04-09,Venezuela,8,Bolivia,0,8,0,Venezuela,Bolivia,1388,1217,171,-171
2646,2018-04-09,Ecuador,3,Argentina,6,6,3,Argentina,Ecuador,1615,1451,164,-164
2647,2018-04-09,Kazakhstan,0,Russia,3,3,0,Russia,Kazakhstan,1713,1329,384,-384
2648,2018-04-09,Croatia,1,Hungary,3,3,1,Hungary,Croatia,1527,1456,71,-71
2649,2018-04-09,Denmark,1,Ukraine,0,1,0,Denmark,Ukraine,1884,1712,172,-172
2650,2018-04-09,Cameroon,5,Congo,0,5,0,Cameroon,Congo,1484,1206,278,-278
2651,2018-04-09,Equatorial Guinea,2,Kenya,0,2,0,Equatorial Guinea,Kenya,1446,870,576,-576
2652,2018-04-09,Philippines,0,China PR,3,3,0,China PR,Philippines,1855,1316,539,-539
2653,2018-04-09,Jordan,1,Thailand,6,6,1,Thailand,Jordan,1676,1460,216,-216
2654,2018-04-10,Colombia,3,Peru,0,3,0,Colombia,Peru,1754,1409,345,-345
2655,2018-04-10,Chile,1,Uruguay,0,1,0,Chile,Uruguay,1567,1355,212,-212
2656,2018-04-10,Colombia,3,Peru,0,3,0,Colombia,Peru,1754,1409,345,-345
2657,2018-04-10,Chile,1,Uruguay,0,1,0,Chile,Uruguay,1567,1355,212,-212
2658,2018-04-10,Bosnia and Herzegovina,0,England,2,2,0,England,Bosnia and Herzegovina,2042,1409,633,-633
2659,2018-04-10,Albania,1,Belarus,0,1,0,Albania,Belarus,1293,1450,-157,157
2660,2018-04-10,Scotland,3,Poland,0,3,0,Scotland,Poland,1793,1668,125,-125
2661,2018-04-10,Republic of Ireland,0,Netherlands,2,2,0,Netherlands,Republic of Ireland,1972,1684,288,-288
2662,2018-04-10,Northern Ireland,0,Norway,3,3,0,Norway,Northern Ireland,1871,1425,446,-446
2663,2018-04-10,Slovenia,0,Germany,4,4,0,Germany,Slovenia,2033,1404,629,-629
2664,2018-04-10,Faroe Islands,0,Iceland,5,5,0,Iceland,Faroe Islands,1819,1296,523,-523
2665,2018-04-10,Italy,2,Belgium,1,2,1,Italy,Belgium,1864,1788,76,-76
2666,2018-04-10,Moldova,0,Romania,0,0,0,Moldova,Romania,1215,1585,-370,370
2667,2018-04-10,Israel,0,Serbia,1,1,0,Serbia,Israel,1534,1409,125,-125
2668,2018-04-10,Austria,0,Spain,1,1,0,Spain,Austria,1886,1800,86,-86
2669,2018-04-10,Algeria,2,Senegal,0,2,0,Algeria,Senegal,1283,1245,38,-38
2670,2018-04-10,Côte d'Ivoire,0,Morocco,0,0,0,Côte d'Ivoire,Morocco,1382,1298,84,-84
2671,2018-04-10,Gambia,2,Burkina Faso,1,2,1,Gambia,Burkina Faso,1183,1062,121,-121
2672,2018-04-10,Swaziland,1,Lesotho,2,2,1,Lesotho,Swaziland,836,832,4,-4
2673,2018-04-10,Ethiopia,2,Algeria,3,3,2,Algeria,Ethiopia,1283,1143,140,-140
2674,2018-04-10,Mali,0,Côte d'Ivoire,0,0,0,Mali,Côte d'Ivoire,1222,1382,-160,160
2675,2018-04-10,South Africa,6,Lesotho,0,6,0,South Africa,Lesotho,1450,836,614,-614
2676,2018-04-10,Zimbabwe,1,Zambia,2,2,1,Zambia,Zimbabwe,1048,1204,-156,156
2677,2018-04-10,Korea Republic,0,Japan,0,0,0,Korea Republic,Japan,1860,1950,-90,90
2678,2018-04-10,Vietnam,0,Australia,8,8,0,Australia,Vietnam,2018,1640,378,-378
2679,2018-04-11,Ecuador,0,Bolivia,1,1,0,Bolivia,Ecuador,1217,1451,-234,234
2680,2018-04-11,Brazil,4,Venezuela,0,4,0,Brazil,Venezuela,1968,1388,580,-580
2681,2018-04-11,Ecuador,0,Bolivia,1,1,0,Bolivia,Ecuador,1217,1451,-234,234
2682,2018-04-11,Brazil,4,Venezuela,0,4,0,Brazil,Venezuela,1968,1388,580,-580
2683,2018-04-12,Paraguay,2,Uruguay,1,2,1,Paraguay,Uruguay,1465,1355,110,-110
2684,2018-04-12,Peru,0,Chile,5,5,0,Chile,Peru,1567,1409,158,-158
2685,2018-04-12,Paraguay,2,Uruguay,1,2,1,Paraguay,Uruguay,1465,1355,110,-110
2686,2018-04-12,Chile,5,Peru,0,5,0,Chile,Peru,1567,1409,158,-158
2687,2018-04-12,Jordan,1,China PR,8,8,1,China PR,Jordan,1855,1460,395,-395
2688,2018-04-12,Thailand,3,Philippines,1,3,1,Thailand,Philippines,1676,1316,360,-360
2689,2018-04-13,Argentina,2,Venezuela,0,2,0,Argentina,Venezuela,1615,1388,227,-227
2690,2018-04-13,Bolivia,0,Brazil,7,7,0,Brazil,Bolivia,1968,1217,751,-751
2691,2018-04-13,Argentina,2,Venezuela,0,2,0,Argentina,Venezuela,1615,1388,227,-227
2692,2018-04-13,Bolivia,0,Brazil,7,7,0,Brazil,Bolivia,1968,1217,751,-751
2693,2018-04-13,Japan,1,Australia,1,1,1,Japan,Australia,1950,2018,-68,68
2694,2018-04-13,Korea Republic,4,Vietnam,0,4,0,Korea Republic,Vietnam,1860,1640,220,-220
2695,2018-04-16,Colombia,1,Argentina,3,3,1,Argentina,Colombia,1615,1754,-139,139
2696,2018-04-16,Brazil,3,Chile,1,3,1,Brazil,Chile,1968,1567,401,-401
2697,2018-04-16,Colombia,1,Argentina,3,3,1,Argentina,Colombia,1615,1754,-139,139
2698,2018-04-16,Chile,1,Brazil,3,3,1,Brazil,Chile,1968,1567,401,-401
2699,2018-04-16,Philippines,0,Korea Republic,5,5,0,Korea Republic,Philippines,1860,1316,544,-544
2700,2018-04-17,Australia,2,Thailand,2,2,2,Australia,Thailand,2018,1676,342,-342
2701,2018-04-17,China PR,1,Japan,3,3,1,Japan,China PR,1950,1855,95,-95
2702,2018-04-19,Brazil,3,Argentina,0,3,0,Brazil,Argentina,1968,1615,353,-353
2703,2018-04-19,Colombia,0,Chile,0,0,0,Colombia,Chile,1754,1567,187,-187
2704,2018-04-19,Brazil,3,Argentina,0,3,0,Brazil,Argentina,1968,1615,353,-353
2705,2018-04-19,Chile,0,Colombia,0,0,0,Chile,Colombia,1567,1754,-187,187
2706,2018-04-20,China PR,3,Thailand,1,3,1,China PR,Thailand,1855,1676,179,-179
2707,2018-04-20,Japan,1,Australia,0,1,0,Japan,Australia,1950,2018,-68,68
2708,2018-04-22,Chile,4,Argentina,0,4,0,Chile,Argentina,1567,1615,-48,48
2709,2018-04-22,Brazil,3,Colombia,0,3,0,Brazil,Colombia,1968,1754,214,-214
2710,2018-04-22,Chile,4,Argentina,0,4,0,Chile,Argentina,1567,1615,-48,48
2711,2018-04-22,Brazil,3,Colombia,0,3,0,Brazil,Colombia,1968,1754,214,-214
2712,2018-05-07,Cuba,11,Aruba,0,11,0,Cuba,Aruba,1217,745,472,-472
2713,2018-05-09,Anguilla,1,Aruba,2,2,1,Aruba,Anguilla,745,697,48,-48
2714,2018-05-09,Cuba,2,Puerto Rico,2,2,2,Cuba,Puerto Rico,1217,1156,61,-61
2715,2018-05-11,Aruba,0,Puerto Rico,5,5,0,Puerto Rico,Aruba,1156,745,411,-411
2716,2018-05-11,Dominican Republic,3,Anguilla,0,3,0,Dominican Republic,Anguilla,1191,697,494,-494
2717,2018-05-13,Anguilla,0,Cuba,4,4,0,Cuba,Anguilla,1217,697,520,-520
2718,2018-05-13,Dominican Republic,3,Aruba,0,3,0,Dominican Republic,Aruba,1191,745,446,-446
2719,2018-05-13,Haiti,2,Jamaica,2,2,2,Haiti,Jamaica,1372,1352,20,-20
2720,2018-05-19,Dominica,1,St Kitts and Nevis,2,2,1,St Kitts and Nevis,Dominica,942,900,42,-42
2721,2018-05-19,Trinidad and Tobago,10,US Virgin Islands,0,10,0,Trinidad and Tobago,US Virgin Islands,1484,852,632,-632
2722,2018-05-21,US Virgin Islands,3,Grenada,0,3,0,US Virgin Islands,Grenada,852,914,-62,62
2723,2018-05-21,Trinidad and Tobago,3,Dominica,0,3,0,Trinidad and Tobago,Dominica,1484,900,584,-584
2724,2018-05-23,St Kitts and Nevis,10,Grenada,0,10,0,St Kitts and Nevis,Grenada,942,914,28,-28
2725,2018-05-23,US Virgin Islands,0,Dominica,3,3,0,Dominica,US Virgin Islands,900,852,48,-48
2726,2018-05-23,St Lucia,2,Curacao,1,2,1,St Lucia,Curacao,989,831,158,-158
2727,2018-05-23,Antigua and Barbuda,1,St Vincent and the Grenadines,0,1,0,Antigua and Barbuda,St Vincent and the Grenadines,767,1000,-233,233
2728,2018-05-23,Barbados,2,Suriname,1,2,1,Barbados,Suriname,979,1152,-173,173
2729,2018-05-23,Guyana,2,Bermuda,2,2,2,Guyana,Bermuda,1274,943,331,-331
2730,2018-05-25,Grenada,1,Dominica,1,1,1,Grenada,Dominica,914,900,14,-14
2731,2018-05-25,Trinidad and Tobago,1,St Kitts and Nevis,1,1,1,Trinidad and Tobago,St Kitts and Nevis,1484,942,542,-542
2732,2018-05-25,St Vincent and the Grenadines,1,St Lucia,2,2,1,St Lucia,St Vincent and the Grenadines,989,1000,-11,11
2733,2018-05-25,Antigua and Barbuda,3,Curacao,0,3,0,Antigua and Barbuda,Curacao,767,831,-64,64
2734,2018-05-25,Bermuda,3,Barbados,2,3,2,Bermuda,Barbados,943,979,-36,36
2735,2018-05-25,Guyana,6,Suriname,1,6,1,Guyana,Suriname,1274,1152,122,-122
2736,2018-05-27,St Kitts and Nevis,7,US Virgin Islands,0,7,0,St Kitts and Nevis,US Virgin Islands,942,852,90,-90
2737,2018-05-27,Trinidad and Tobago,13,Grenada,0,13,0,Trinidad and Tobago,Grenada,1484,914,570,-570
2738,2018-05-27,Curacao,1,St Vincent and the Grenadines,0,1,0,Curacao,St Vincent and the Grenadines,831,1000,-169,169
2739,2018-05-27,Antigua and Barbuda,1,St Lucia,0,1,0,Antigua and Barbuda,St Lucia,767,989,-222,222
2740,2018-05-27,Suriname,0,Bermuda,1,1,0,Bermuda,Suriname,943,1152,-209,209
2741,2018-05-27,Guyana,0,Barbados,0,0,0,Guyana,Barbados,1274,979,295,-295
2742,2018-06-06,Nigeria,6,Gambia,0,6,0,Nigeria,Gambia,1608,1183,425,-425
2743,2018-06-07,Wales,1,Bosnia and Herzegovina,0,1,0,Wales,Bosnia and Herzegovina,1644,1409,235,-235
2744,2018-06-07,Scotland,2,Belarus,1,2,1,Scotland,Belarus,1793,1450,343,-343
2745,2018-06-07,Sweden,4,Croatia,0,4,0,Sweden,Croatia,1963,1456,507,-507
2746,2018-06-07,Faroe Islands,0,Slovenia,4,4,0,Slovenia,Faroe Islands,1404,1296,108,-108
2747,2018-06-07,Spain,2,Israel,0,2,0,Spain,Israel,1886,1409,477,-477
2748,2018-06-08,USA,1,China PR,0,1,0,USA,China PR,2115,1855,260,-260
2749,2018-06-08,Russia,1,England,3,3,1,England,Russia,2042,1713,329,-329
2750,2018-06-08,Republic of Ireland,0,Norway,2,2,0,Norway,Republic of Ireland,1871,1684,187,-187
2751,2018-06-08,Northern Ireland,0,Netherlands,5,5,0,Netherlands,Northern Ireland,1972,1425,547,-547
2752,2018-06-08,Ukraine,1,Denmark,5,5,1,Denmark,Ukraine,1884,1712,172,-172
2753,2018-06-08,Italy,3,Portugal,0,3,0,Italy,Portugal,1864,1632,232,-232
2754,2018-06-08,Finland,0,Austria,2,2,0,Austria,Finland,1800,1691,109,-109
2755,2018-06-10,Moldova,0,Belgium,7,7,0,Belgium,Moldova,1788,1215,573,-573
2756,2018-06-11,Iceland,2,Slovenia,0,2,0,Iceland,Slovenia,1819,1404,415,-415
2757,2018-06-12,Bosnia and Herzegovina,0,Kazakhstan,2,2,0,Kazakhstan,Bosnia and Herzegovina,1329,1409,-80,80
2758,2018-06-12,Wales,3,Russia,0,3,0,Wales,Russia,1644,1713,-69,69
2759,2018-06-12,Poland,2,Scotland,3,3,2,Scotland,Poland,1793,1668,125,-125
2760,2018-06-12,Belarus,0,Switzerland,5,5,0,Switzerland,Belarus,1849,1450,399,-399
2761,2018-06-12,Norway,1,Republic of Ireland,0,1,0,Norway,Republic of Ireland,1871,1684,187,-187
2762,2018-06-12,Netherlands,1,Slovakia,0,1,0,Netherlands,Slovakia,1972,1498,474,-474
2763,2018-06-12,Denmark,5,Hungary,1,5,1,Denmark,Hungary,1884,1527,357,-357
2764,2018-06-12,Ukraine,1,Sweden,0,1,0,Ukraine,Sweden,1712,1963,-251,251
2765,2018-06-12,Czech Republic,4,Faroe Islands,1,4,1,Czech Republic,Faroe Islands,1649,1296,353,-353
2766,2018-06-12,Romania,1,Portugal,1,1,1,Romania,Portugal,1585,1632,-47,47
2767,2018-06-12,Serbia,0,Finland,2,2,0,Finland,Serbia,1691,1534,157,-157
2768,2018-06-12,Israel,0,Austria,6,6,0,Austria,Israel,1800,1409,391,-391
2769,2018-06-13,USA,2,China PR,1,2,1,USA,China PR,2115,1855,260,-260
2770,2018-07-26,Brazil,1,Australia,3,3,1,Australia,Brazil,1979,1985,-6,6
2771,2018-07-26,USA,4,Japan,2,4,2,USA,Japan,2114,1988,126,-126
2772,2018-07-29,Japan,1,Brazil,2,2,1,Brazil,Japan,1985,1988,-3,3
2773,2018-07-29,USA,1,Australia,1,1,1,USA,Australia,2114,1979,135,-135
2774,2018-08-02,Australia,2,Japan,0,2,0,Australia,Japan,1979,1988,-9,9
2775,2018-08-02,USA,4,Brazil,1,4,1,USA,Brazil,2114,1985,129,-129
2776,2018-08-24,American Samoa,0,Solomon Islands,2,2,0,Solomon Islands,American Samoa,1144,1075,69,-69
2777,2018-08-24,Fiji,5,Vanuatu,1,5,1,Fiji,Vanuatu,1292,1139,153,-153
2778,2018-08-25,Cuba,2,Trinidad and Tobago,3,3,2,Trinidad and Tobago,Cuba,1473,1241,232,-232
2779,2018-08-25,Jamaica,9,Antigua and Barbuda,0,9,0,Jamaica,Antigua and Barbuda,1348,798,550,-550
2780,2018-08-27,Vanuatu,1,American Samoa,0,1,0,Vanuatu,American Samoa,1139,1075,64,-64
2781,2018-08-27,Fiji,0,Solomon Islands,0,0,0,Fiji,Solomon Islands,1292,1144,148,-148
2782,2018-08-27,Panama,4,Nicaragua,0,4,0,Panama,Nicaragua,1363,1073,290,-290
2783,2018-08-27,Costa Rica,11,El Salvador,0,11,0,Costa Rica,El Salvador,1645,1198,447,-447
2784,2018-08-27,Antigua and Barbuda,0,Cuba,7,7,0,Cuba,Antigua and Barbuda,1241,798,443,-443
2785,2018-08-27,Jamaica,4,Bermuda,0,4,0,Jamaica,Bermuda,1348,984,364,-364
2786,2018-08-29,Costa Rica,4,Nicaragua,1,4,1,Costa Rica,Nicaragua,1645,1073,572,-572
2787,2018-08-29,El Salvador,2,Panama,6,6,2,Panama,El Salvador,1363,1198,165,-165
2788,2018-08-29,Trinidad and Tobago,5,Antigua and Barbuda,0,5,0,Trinidad and Tobago,Antigua and Barbuda,1473,798,675,-675
2789,2018-08-29,Cuba,2,Bermuda,0,2,0,Cuba,Bermuda,1241,984,257,-257
2790,2018-08-30,Solomon Islands,0,Vanuatu,1,1,0,Vanuatu,Solomon Islands,1139,1144,-5,5
2791,2018-08-30,Fiji,2,American Samoa,0,2,0,Fiji,American Samoa,1292,1075,217,-217
2792,2018-08-30,Russia,3,Kazakhstan,0,3,0,Russia,Kazakhstan,1702,1353,349,-349
2793,2018-08-30,Scotland,2,Switzerland,1,2,1,Scotland,Switzerland,1801,1861,-60,60
2794,2018-08-30,Sweden,3,Ukraine,0,3,0,Sweden,Ukraine,1941,1731,210,-210
2795,2018-08-30,Denmark,1,Croatia,1,1,1,Denmark,Croatia,1903,1425,478,-478
2796,2018-08-30,Moldova,0,Portugal,7,7,0,Portugal,Moldova,1644,1228,416,-416
2797,2018-08-31,El Salvador,2,Nicaragua,2,2,2,El Salvador,Nicaragua,1198,1073,125,-125
2798,2018-08-31,Costa Rica,3,Panama,1,3,1,Costa Rica,Panama,1645,1363,282,-282
2799,2018-08-31,Antigua and Barbuda,0,Bermuda,5,5,0,Bermuda,Antigua and Barbuda,984,798,186,-186
2800,2018-08-31,Jamaica,4,Trinidad and Tobago,1,4,1,Jamaica,Trinidad and Tobago,1348,1473,-125,125
2801,2018-08-31,Wales,0,England,3,3,0,England,Wales,2026,1679,347,-347
2802,2018-08-31,Belarus,1,Poland,4,4,1,Poland,Belarus,1629,1431,198,-198
2803,2018-08-31,Republic of Ireland,4,Northern Ireland,0,4,0,Republic of Ireland,Northern Ireland,1664,1419,245,-245
2804,2018-08-31,Slovakia,0,Norway,4,4,0,Norway,Slovakia,1887,1503,384,-384
2805,2018-08-31,Czech Republic,2,Slovenia,0,2,0,Czech Republic,Slovenia,1648,1423,225,-225
2806,2018-08-31,Romania,0,Belgium,1,1,0,Belgium,Romania,1773,1567,206,-206
2807,2018-08-31,Spain,5,Finland,1,5,1,Spain,Finland,1911,1678,233,-233
2808,2018-09-01,USA,3,Chile,0,3,0,USA,Chile,2114,1594,520,-520
2809,2018-09-01,Iceland,0,Germany,2,2,0,Germany,Iceland,2049,1823,226,-226
2810,2018-09-02,Bermuda,0,Trinidad and Tobago,3,3,0,Trinidad and Tobago,Bermuda,1473,984,489,-489
2811,2018-09-02,Jamaica,6,Cuba,1,6,1,Jamaica,Cuba,1348,1241,107,-107
2812,2018-09-04,Russia,3,Bosnia and Herzegovina,0,3,0,Russia,Bosnia and Herzegovina,1702,1373,329,-329
2813,2018-09-04,Kazakhstan,0,England,6,6,0,England,Kazakhstan,2026,1353,673,-673
2814,2018-09-04,Poland,0,Switzerland,0,0,0,Poland,Switzerland,1629,1861,-232,232
2815,2018-09-04,Albania,1,Scotland,2,2,1,Scotland,Albania,1801,1325,476,-476
2816,2018-09-04,Norway,2,Netherlands,1,2,1,Norway,Netherlands,1887,1977,-90,90
2817,2018-09-04,Northern Ireland,0,Slovakia,1,1,0,Slovakia,Northern Ireland,1503,1419,84,-84
2818,2018-09-04,Denmark,0,Sweden,1,1,0,Sweden,Denmark,1941,1903,38,-38
2819,2018-09-04,Ukraine,2,Hungary,0,2,0,Ukraine,Hungary,1731,1537,194,-194
2820,2018-09-04,Iceland,1,Czech Republic,1,1,1,Iceland,Czech Republic,1823,1648,175,-175
2821,2018-09-04,Faroe Islands,0,Germany,8,8,0,Germany,Faroe Islands,2049,1272,777,-777
2822,2018-09-04,Belgium,2,Italy,1,2,1,Belgium,Italy,1773,1870,-97,97
2823,2018-09-04,Portugal,5,Romania,1,5,1,Portugal,Romania,1644,1567,77,-77
2824,2018-09-04,Austria,4,Finland,1,4,1,Austria,Finland,1794,1678,116,-116
2825,2018-09-04,Spain,3,Serbia,0,3,0,Spain,Serbia,1911,1545,366,-366
2826,2018-09-05,USA,4,Chile,0,4,0,USA,Chile,2114,1594,520,-520
2827,2018-10-04,Trinidad and Tobago,0,Panama,3,3,0,Panama,Trinidad and Tobago,1376,1443,-67,67
2828,2018-10-04,USA,6,Mexico,0,6,0,USA,Mexico,2114,1732,382,-382
2829,2018-10-05,Puerto Rico,10,Anguilla,0,10,0,Puerto Rico,Anguilla,1166,697,469,-469
2830,2018-10-05,Dominican Republic,1,Cuba,5,5,1,Cuba,Dominican Republic,1238,1169,69,-69
2831,2018-10-05,Costa Rica,8,Cuba,0,8,0,Costa Rica,Cuba,1658,1238,420,-420
2832,2018-10-05,Canada,2,Jamaica,0,2,0,Canada,Jamaica,2014,1387,627,-627
2833,2018-10-05,Netherlands,2,Denmark,0,2,0,Netherlands,Denmark,1963,1864,99,-99
2834,2018-10-05,Belgium,2,Switzerland,2,2,2,Belgium,Switzerland,1797,1840,-43,43
2835,2018-10-07,USA,5,Panama,0,5,0,USA,Panama,2114,1376,738,-738
2836,2018-10-07,Mexico,4,Trinidad and Tobago,1,4,1,Mexico,Trinidad and Tobago,1732,1443,289,-289
2837,2018-10-08,Jamaica,1,Costa Rica,0,1,0,Jamaica,Costa Rica,1387,1658,-271,271
2838,2018-10-08,Cuba,0,Canada,12,12,0,Canada,Cuba,2014,1238,776,-776
2839,2018-10-09,Denmark,1,Netherlands,2,2,1,Netherlands,Denmark,1963,1864,99,-99
2840,2018-10-09,Switzerland,1,Belgium,1,1,1,Switzerland,Belgium,1840,1797,43,-43
2841,2018-10-10,Panama,2,Mexico,0,2,0,Panama,Mexico,1376,1732,-356,356
2842,2018-10-10,USA,7,Trinidad and Tobago,0,7,0,USA,Trinidad and Tobago,2114,1443,671,-671
2843,2018-10-11,Cuba,0,Jamaica,9,9,0,Jamaica,Cuba,1387,1238,149,-149
2844,2018-10-11,Costa Rica,1,Canada,3,3,1,Canada,Costa Rica,2014,1658,356,-356
2845,2018-10-14,Panama,0,Canada,7,7,0,Canada,Panama,2014,1376,638,-638
2846,2018-10-14,USA,6,Jamaica,0,6,0,USA,Jamaica,2114,1387,727,-727
2847,2018-10-17,Panama,2,Jamaica,2,2,2,Panama,Jamaica,1376,1387,-11,11
2848,2018-10-17,USA,2,Canada,0,2,0,USA,Canada,2114,2014,100,-100
2849,2018-11-08,Portugal,0,USA,1,1,0,USA,Portugal,2114,1659,455,-455
2850,2018-11-08,Argentina,4,Panama,0,4,0,Argentina,Panama,1633,1376,257,-257
2851,2018-11-09,Netherlands,3,Switzerland,0,3,0,Netherlands,Switzerland,1963,1840,123,-123
2852,2018-11-13,Switzerland,1,Netherlands,1,1,1,Switzerland,Netherlands,1840,1963,-123,123
2853,2018-11-13,Panama,1,Argentina,1,1,1,Panama,Argentina,1376,1633,-257,257
2854,2018-11-14,Scotland,0,USA,1,1,0,USA,Scotland,2114,1811,303,-303
2855,2018-11-17,Ghana,1,Algeria,0,1,0,Ghana,Algeria,1503,1294,209,-209
2856,2018-11-17,Mali,1,Cameroon,2,2,1,Cameroon,Mali,1478,1232,246,-246
2857,2018-11-18,Nigeria,0,South Africa,1,1,0,South Africa,Nigeria,1446,1607,-161,161
2858,2018-11-18,Zambia,5,Equatorial Guinea,0,5,0,Zambia,Equatorial Guinea,1053,1421,-368,368
2859,2018-11-18,Samoa,0,Papua New Guinea,5,5,0,Papua New Guinea,Samoa,1473,1138,335,-335
2860,2018-11-18,New Caledonia,4,Tahiti,2,4,2,New Caledonia,Tahiti,1252,1238,14,-14
2861,2018-11-19,New Zealand,11,Tonga,0,11,0,New Zealand,Tonga,1810,1258,552,-552
2862,2018-11-19,Cook Islands,0,Fiji,3,3,0,Fiji,Cook Islands,1286,1185,101,-101
2863,2018-11-20,Ghana,1,Mali,2,2,1,Mali,Ghana,1232,1503,-271,271
2864,2018-11-20,Cameroon,3,Algeria,0,3,0,Cameroon,Algeria,1478,1294,184,-184
2865,2018-11-21,Nigeria,4,Zambia,0,4,0,Nigeria,Zambia,1607,1053,554,-554
2866,2018-11-21,Equatorial Guinea,1,South Africa,7,7,1,South Africa,Equatorial Guinea,1446,1421,25,-25
2867,2018-11-21,Tahiti,5,Samoa,5,5,5,Tahiti,Samoa,1238,1138,100,-100
2868,2018-11-21,New Caledonia,2,Papua New Guinea,6,6,2,Papua New Guinea,New Caledonia,1473,1252,221,-221
2869,2018-11-22,Tonga,0,Fiji,12,12,0,Fiji,Tonga,1286,1258,28,-28
2870,2018-11-22,New Zealand,6,Cook Islands,0,6,0,New Zealand,Cook Islands,1810,1185,625,-625
2871,2018-11-23,Ghana,1,Cameroon,1,1,1,Ghana,Cameroon,1503,1478,25,-25
2872,2018-11-23,Algeria,2,Mali,3,3,2,Mali,Algeria,1232,1294,-62,62
2873,2018-11-24,Equatorial Guinea,0,Nigeria,6,6,0,Nigeria,Equatorial Guinea,1607,1421,186,-186
2874,2018-11-24,South Africa,1,Zambia,1,1,1,South Africa,Zambia,1446,1053,393,-393
2875,2018-11-24,Papua New Guinea,3,Tahiti,1,3,1,Papua New Guinea,Tahiti,1473,1238,235,-235
2876,2018-11-24,New Caledonia,2,Samoa,0,2,0,New Caledonia,Samoa,1252,1138,114,-114
2877,2018-11-25,Tonga,1,Cook Islands,0,1,0,Tonga,Cook Islands,1258,1185,73,-73
2878,2018-11-25,Fiji,0,New Zealand,10,10,0,New Zealand,Fiji,1810,1286,524,-524
2879,2018-11-27,Cameroon,0,Nigeria,0,0,0,Cameroon,Nigeria,1478,1607,-129,129
2880,2018-11-27,South Africa,2,Mali,0,2,0,South Africa,Mali,1446,1232,214,-214
2881,2018-11-28,Papua New Guinea,1,Fiji,5,5,1,Fiji,Papua New Guinea,1286,1473,-187,187
2882,2018-11-28,New Caledonia,0,New Zealand,8,8,0,New Zealand,New Caledonia,1810,1252,558,-558
2883,2018-11-30,Cameroon,4,Mali,2,4,2,Cameroon,Mali,1478,1232,246,-246
2884,2018-12-01,Nigeria,0,South Africa,0,0,0,Nigeria,South Africa,1607,1446,161,-161
2885,2018-12-01,New Caledonia,1,Papua New Guinea,7,7,1,Papua New Guinea,New Caledonia,1473,1252,221,-221
2886,2018-12-01,Fiji,0,New Zealand,8,8,0,New Zealand,Fiji,1810,1286,524,-524
2887,2019-01-17,Korea Republic,3,Romania,0,3,0,Korea Republic,Romania,1880,1549,331,-331
2888,2019-01-17,China PR,3,Nigeria,0,3,0,China PR,Nigeria,1871,1586,285,-285
2889,2019-01-20,France,3,USA,1,3,1,France,USA,2046,2123,-77,77
2890,2019-01-20,Romania,1,Nigeria,4,4,1,Nigeria,Romania,1586,1549,37,-37
2891,2019-01-20,China PR,1,Korea Republic,0,1,0,China PR,Korea Republic,1871,1880,-9,9
2892,2019-01-23,Spain,0,USA,1,1,0,USA,Spain,2123,1920,203,-203
2893,2019-02-27,Canada,0,Iceland,0,0,0,Canada,Iceland,2006,1798,208,-208
2894,2019-02-27,Spain,2,Netherlands,0,2,0,Spain,Netherlands,1920,1987,-67,67
2895,2019-02-27,Norway,2,Denmark,1,2,1,Norway,Denmark,1902,1842,60,-60
2896,2019-02-27,Sweden,4,Switzerland,1,4,1,Sweden,Switzerland,1976,1832,144,-144
2897,2019-02-27,USA,2,Japan,2,2,2,USA,Japan,2123,1984,139,-139
2898,2019-02-27,England,2,Brazil,1,2,1,England,Brazil,2021,1964,57,-57
2899,2019-02-27,South Africa,2,Finland,2,2,2,South Africa,Finland,1480,1672,-192,192
2900,2019-02-27,Korea DPR,4,Czech Republic,2,4,2,Korea DPR,Czech Republic,1938,1668,270,-270
2901,2019-02-27,Mexico,0,Italy,5,5,0,Italy,Mexico,1859,1698,161,-161
2902,2019-02-27,Thailand,4,Hungary,0,4,0,Thailand,Hungary,1670,1524,146,-146
2903,2019-02-27,Belgium,3,Slovakia,0,3,0,Belgium,Slovakia,1803,1509,294,-294
2904,2019-02-27,Nigeria,1,Austria,4,4,1,Austria,Nigeria,1797,1586,211,-211
2905,2019-03-01,Scotland,0,Canada,1,1,0,Canada,Scotland,2006,1810,196,-196
2906,2019-03-01,Poland,3,Spain,0,3,0,Poland,Spain,1656,1920,-264,264
2907,2019-03-01,China PR,1,Norway,3,3,1,Norway,China PR,1902,1871,31,-31
2908,2019-03-01,Portugal,2,Sweden,1,2,1,Portugal,Sweden,1665,1976,-311,311
2909,2019-03-01,Finland,1,Czech Republic,2,2,1,Czech Republic,Finland,1668,1672,-4,4
2910,2019-03-01,South Africa,1,Korea DPR,4,4,1,Korea DPR,South Africa,1938,1480,458,-458
2911,2019-03-01,Thailand,1,Mexico,2,2,1,Mexico,Thailand,1698,1670,28,-28
2912,2019-03-01,Hungary,0,Italy,3,3,0,Italy,Hungary,1859,1524,335,-335
2913,2019-03-01,Slovakia,3,Nigeria,4,4,3,Nigeria,Slovakia,1586,1509,77,-77
2914,2019-03-01,Austria,0,Belgium,0,0,0,Austria,Belgium,1797,1803,-6,6
2915,2019-03-02,Brazil,1,Japan,3,3,1,Japan,Brazil,1984,1964,20,-20
2916,2019-03-02,USA,2,England,2,2,2,USA,England,2123,2021,102,-102
2917,2019-03-04,Iceland,1,Scotland,4,4,1,Scotland,Iceland,1810,1798,12,-12
2918,2019-03-04,Netherlands,0,Poland,1,1,0,Poland,Netherlands,1656,1987,-331,331
2919,2019-03-04,Denmark,1,China PR,0,1,0,Denmark,China PR,1842,1871,-29,29
2920,2019-03-04,Portugal,1,Switzerland,3,3,1,Switzerland,Portugal,1832,1665,167,-167
2921,2019-03-04,Czech Republic,2,South Africa,1,2,1,Czech Republic,South Africa,1668,1480,188,-188
2922,2019-03-04,Finland,0,Korea DPR,1,1,0,Korea DPR,Finland,1938,1672,266,-266
2923,2019-03-04,Italy,4,Thailand,1,4,1,Italy,Thailand,1859,1670,189,-189
2924,2019-03-04,Mexico,3,Hungary,3,3,3,Mexico,Hungary,1698,1524,174,-174
2925,2019-03-04,Slovakia,0,Austria,1,1,0,Austria,Slovakia,1797,1509,288,-288
2926,2019-03-04,Nigeria,0,Belgium,1,1,0,Belgium,Nigeria,1803,1586,217,-217
2927,2019-03-05,Japan,0,England,3,3,0,England,Japan,2021,1984,37,-37
2928,2019-03-05,USA,1,Brazil,0,1,0,USA,Brazil,2123,1964,159,-159
2929,2019-03-06,China PR,1,Netherlands,1,1,1,China PR,Netherlands,1871,1987,-116,116
2930,2019-03-06,Portugal,1,Iceland,4,4,1,Iceland,Portugal,1798,1665,133,-133
2931,2019-03-06,Switzerland,0,Spain,2,2,0,Spain,Switzerland,1920,1832,88,-88
2932,2019-03-06,Scotland,1,Denmark,0,1,0,Scotland,Denmark,1810,1842,-32,32
2933,2019-03-06,Canada,0,Sweden,0,0,0,Canada,Sweden,2006,1976,30,-30
2934,2019-03-06,Poland,0,Norway,3,3,0,Norway,Poland,1902,1656,246,-246
2935,2019-03-06,Slovakia,2,Hungary,3,3,2,Hungary,Slovakia,1524,1509,15,-15
2936,2019-03-06,Finland,3,South Africa,0,3,0,Finland,South Africa,1672,1480,192,-192
2937,2019-03-06,Nigeria,3,Thailand,0,3,0,Nigeria,Thailand,1586,1670,-84,84
2938,2019-03-06,Czech Republic,1,Mexico,2,2,1,Mexico,Czech Republic,1698,1668,30,-30
2939,2019-03-06,Austria,0,Belgium,0,0,0,Austria,Belgium,1797,1803,-6,6
2940,2019-03-06,Korea DPR,3,Italy,3,3,3,Korea DPR,Italy,1938,1859,79,-79
2941,2019-04-05,USA,5,Australia,3,5,3,USA,Australia,2101,2003,98,-98
2942,2019-04-08,USA,6,Belgium,0,6,0,USA,Belgium,2101,1812,289,-289
2943,2019-05-13,USA,3,South Africa,0,3,0,USA,South Africa,2101,1485,616,-616
2944,2019-05-17,USA,5,New Zealand,0,5,0,USA,New Zealand,2101,1815,286,-286
2945,2019-05-26,USA,3,Mexico,0,3,0,USA,Mexico,2101,1700,401,-401
2946,2019-06-07,France,4,Korea Republic,0,4,0,France,Korea Republic,2043,1883,160,-160
2947,2019-06-08,Norway,3,Nigeria,0,3,0,Norway,Nigeria,1915,1599,316,-316
2948,2019-06-08,Germany,1,China PR,0,1,0,Germany,China PR,2072,1866,206,-206
2949,2019-06-08,Spain,3,South Africa,1,3,1,Spain,South Africa,1913,1485,428,-428
2950,2019-06-09,Australia,1,Italy,2,2,1,Italy,Australia,1868,2003,-135,135
2951,2019-06-09,Brazil,3,Jamaica,0,3,0,Brazil,Jamaica,1944,1449,495,-495
2952,2019-06-09,England,2,Scotland,1,2,1,England,Scotland,2049,1812,237,-237
2953,2019-06-10,Argentina,0,Japan,0,0,0,Argentina,Japan,1626,1991,-365,365
2954,2019-06-10,Canada,1,Cameroon,0,1,0,Canada,Cameroon,2006,1499,507,-507
2955,2019-06-11,New Zealand,0,Netherlands,1,1,0,Netherlands,New Zealand,1967,1815,152,-152
2956,2019-06-11,Chile,0,Sweden,2,2,0,Sweden,Chile,1962,1589,373,-373
2957,2019-06-11,USA,13,Thailand,0,13,0,USA,Thailand,2101,1658,443,-443
2958,2019-06-12,Nigeria,2,Korea Republic,0,2,0,Nigeria,Korea Republic,1599,1883,-284,284
2959,2019-06-12,France,2,Norway,1,2,1,France,Norway,2043,1915,128,-128
2960,2019-06-12,Germany,1,Spain,0,1,0,Germany,Spain,2072,1913,159,-159
2961,2019-06-13,South Africa,0,China PR,1,1,0,China PR,South Africa,1866,1485,381,-381
2962,2019-06-13,Australia,3,Brazil,2,3,2,Australia,Brazil,2003,1944,59,-59
2963,2019-06-14,Jamaica,0,Italy,5,5,0,Italy,Jamaica,1868,1449,419,-419
2964,2019-06-14,Japan,2,Scotland,1,2,1,Japan,Scotland,1991,1812,179,-179
2965,2019-06-14,England,1,Argentina,0,1,0,England,Argentina,2049,1626,423,-423
2966,2019-06-15,Netherlands,3,Cameroon,1,3,1,Netherlands,Cameroon,1967,1499,468,-468
2967,2019-06-15,Canada,2,New Zealand,0,2,0,Canada,New Zealand,2006,1815,191,-191
2968,2019-06-16,Sweden,5,Thailand,1,5,1,Sweden,Thailand,1962,1658,304,-304
2969,2019-06-16,USA,3,Chile,0,3,0,USA,Chile,2101,1589,512,-512
2970,2019-06-17,France,1,Nigeria,0,1,0,France,Nigeria,2043,1599,444,-444
2971,2019-06-17,Korea Republic,1,Norway,2,2,1,Norway,Korea Republic,1915,1883,32,-32
2972,2019-06-17,South Africa,0,Germany,4,4,0,Germany,South Africa,2072,1485,587,-587
2973,2019-06-17,China PR,0,Spain,0,0,0,China PR,Spain,1866,1913,-47,47
2974,2019-06-18,Jamaica,1,Australia,4,4,1,Australia,Jamaica,2003,1449,554,-554
2975,2019-06-18,Italy,0,Brazil,1,1,0,Brazil,Italy,1944,1868,76,-76
2976,2019-06-19,Japan,0,England,2,2,0,England,Japan,2049,1991,58,-58
2977,2019-06-19,Scotland,3,Argentina,3,3,3,Scotland,Argentina,1812,1626,186,-186
2978,2019-06-20,Netherlands,2,Canada,1,2,1,Netherlands,Canada,1967,2006,-39,39
2979,2019-06-20,Cameroon,2,New Zealand,1,2,1,Cameroon,New Zealand,1499,1815,-316,316
2980,2019-06-20,Sweden,0,USA,2,2,0,USA,Sweden,2101,1962,139,-139
2981,2019-06-20,Thailand,0,Chile,2,2,0,Chile,Thailand,1589,1658,-69,69
2982,2019-06-20,Montenegro,0,Greece,4,4,0,Greece,Montenegro,1376,1214,162,-162
2983,2019-06-22,Germany,3,Nigeria,0,3,0,Germany,Nigeria,2072,1599,473,-473
2984,2019-06-22,Norway,1,Australia,1,1,1,Norway,Australia,1915,2003,-88,88
2985,2019-06-23,England,3,Cameroon,0,3,0,England,Cameroon,2049,1499,550,-550
2986,2019-06-23,France,2,Brazil,1,2,1,France,Brazil,2043,1944,99,-99
2987,2019-06-24,Spain,1,USA,2,2,1,USA,Spain,2101,1913,188,-188
2988,2019-06-24,Sweden,1,Canada,0,1,0,Sweden,Canada,1962,2006,-44,44
2989,2019-06-25,Italy,2,China PR,0,2,0,Italy,China PR,1868,1866,2,-2
2990,2019-06-25,Netherlands,2,Japan,1,2,1,Netherlands,Japan,1967,1991,-24,24
2991,2019-06-27,Norway,0,England,3,3,0,England,Norway,2049,1915,134,-134
2992,2019-06-28,France,1,USA,2,2,1,USA,France,2101,2043,58,-58
2993,2019-06-29,Italy,0,Netherlands,2,2,0,Netherlands,Italy,1967,1868,99,-99
2994,2019-06-29,Germany,1,Sweden,2,2,1,Sweden,Germany,1962,2072,-110,110
2995,2019-07-02,England,1,USA,2,2,1,USA,England,2101,2049,52,-52
2996,2019-07-03,Netherlands,1,Sweden,0,1,0,Netherlands,Sweden,1967,1962,5,-5
2997,2019-07-06,England,1,Sweden,2,2,1,Sweden,England,1962,2049,-87,87
2998,2019-07-07,USA,2,Netherlands,0,2,0,USA,Netherlands,2101,1967,134,-134
2999,2019-07-20,Malta,1,Israel,1,1,1,Malta,Israel,1192,1392,-200,200
3000,2019-07-20,Azerbaijan,0,Czech Republic,4,4,0,Czech Republic,Azerbaijan,1679,1345,334,-334
3001,2019-07-20,Finland,4,Cyprus,0,4,0,Finland,Cyprus,1668,1123,545,-545
3002,2019-08-04,USA,3,Republic of Ireland,0,3,0,USA,Republic of Ireland,2180,1666,514,-514
3003,2019-08-20,Turkey,0,Netherlands,8,8,0,Netherlands,Turkey,2037,1412,625,-625
3004,2019-08-20,Italy,6,Georgia,0,6,0,Italy,Georgia,1891,1143,748,-748
3005,2019-08-20,Albania,0,Scotland,5,5,0,Scotland,Albania,1791,1326,465,-465
3006,2019-08-20,Slovakia,0,Hungary,0,0,0,Slovakia,Hungary,1500,1525,-25,25
3007,2019-08-20,North Macedonia,0,Austria,3,3,0,Austria,North Macedonia,1793,1053,740,-740
3008,2019-08-20,Romania,3,Lithuania,0,3,0,Romania,Lithuania,1548,1172,376,-376
3009,2019-08-20,Croatia,1,Belgium,4,4,1,Belgium,Croatia,1813,1440,373,-373
3010,2019-08-20,Norway,6,Northern Ireland,0,6,0,Norway,Northern Ireland,1917,1420,497,-497
3011,2019-08-29,Israel,2,Italy,3,3,2,Italy,Israel,1891,1392,499,-499
3012,2019-08-29,Denmark,8,Malta,0,8,0,Denmark,Malta,1839,1192,647,-647
3013,2019-08-29,Iceland,4,Hungary,1,4,1,Iceland,Hungary,1822,1525,297,-297
3014,2019-08-29,Lithuania,1,Croatia,2,2,1,Croatia,Lithuania,1440,1172,268,-268
3015,2019-08-29,Faroe Islands,0,Wales,6,6,0,Wales,Faroe Islands,1667,1272,395,-395
3016,2019-08-30,USA,4,Portugal,0,4,0,USA,Portugal,2180,1671,509,-509
3017,2019-08-30,Estonia,0,Netherlands,7,7,0,Netherlands,Estonia,2037,1212,825,-825
3018,2019-08-30,Slovenia,0,Russia,1,1,0,Russia,Slovenia,1704,1453,251,-251
3019,2019-08-30,Kosovo,2,Turkey,0,2,0,Kosovo,Turkey,1059,1412,-353,353
3020,2019-08-30,Bosnia and Herzegovina,7,Georgia,1,7,1,Bosnia and Herzegovina,Georgia,1371,1143,228,-228
3021,2019-08-30,Moldova,0,Czech Republic,7,7,0,Czech Republic,Moldova,1679,1219,460,-460
3022,2019-08-30,Scotland,8,Cyprus,0,8,0,Scotland,Cyprus,1791,1123,668,-668
3023,2019-08-30,Northern Ireland,0,Norway,6,6,0,Norway,Northern Ireland,1917,1420,497,-497
3024,2019-08-31,Germany,10,Montenegro,0,10,0,Germany,Montenegro,2059,1217,842,-842
3025,2019-09-01,Kazakhstan,0,Serbia,3,3,0,Serbia,Kazakhstan,1546,1349,197,-197
3026,2019-09-02,Albania,0,Finland,3,3,0,Finland,Albania,1668,1326,342,-342
3027,2019-09-02,Iceland,1,Slovakia,0,1,0,Iceland,Slovakia,1822,1500,322,-322
3028,2019-09-03,Slovenia,5,Kosovo,0,5,0,Slovenia,Kosovo,1453,1059,394,-394
3029,2019-09-03,Russia,4,Estonia,0,4,0,Russia,Estonia,1704,1212,492,-492
3030,2019-09-03,Netherlands,3,Turkey,0,3,0,Netherlands,Turkey,2037,1412,625,-625
3031,2019-09-03,Georgia,0,Italy,1,1,0,Italy,Georgia,1891,1143,748,-748
3032,2019-09-03,Bosnia and Herzegovina,2,Malta,0,2,0,Bosnia and Herzegovina,Malta,1371,1192,179,-179
3033,2019-09-03,Israel,0,Denmark,3,3,0,Denmark,Israel,1839,1392,447,-447
3034,2019-09-03,Latvia,1,Sweden,4,4,1,Sweden,Latvia,2021,1228,793,-793
3035,2019-09-03,Austria,3,North Macedonia,0,3,0,Austria,North Macedonia,1793,1053,740,-740
3036,2019-09-03,Switzerland,4,Lithuania,0,4,0,Switzerland,Lithuania,1815,1172,643,-643
3037,2019-09-03,Belgium,6,Croatia,1,6,1,Belgium,Croatia,1813,1440,373,-373
3038,2019-09-03,Ukraine,0,Germany,8,8,0,Germany,Ukraine,2059,1708,351,-351
3039,2019-09-03,Republic of Ireland,2,Montenegro,0,2,0,Republic of Ireland,Montenegro,1666,1217,449,-449
3040,2019-09-03,Belarus,6,Faroe Islands,0,6,0,Belarus,Faroe Islands,1446,1272,174,-174
3041,2019-09-03,Wales,2,Northern Ireland,2,2,2,Wales,Northern Ireland,1667,1420,247,-247
3042,2019-09-04,USA,3,Portugal,0,3,0,USA,Portugal,2180,1671,509,-509
3043,2019-09-20,France,6,Serbia,0,6,0,France,Serbia,2029,1546,483,-483
3044,2019-10-02,North Macedonia,4,Kazakhstan,1,4,1,North Macedonia,Kazakhstan,1054,1339,-285,285
3045,2019-10-04,USA,2,Korea Republic,0,2,0,USA,Korea Republic,2180,1805,375,-375
3046,2019-10-04,Turkey,0,Estonia,0,0,0,Turkey,Estonia,1391,1212,179,-179
3047,2019-10-04,Slovenia,2,Netherlands,4,4,2,Netherlands,Slovenia,2036,1450,586,-586
3048,2019-10-04,Denmark,2,Bosnia and Herzegovina,0,2,0,Denmark,Bosnia and Herzegovina,1842,1377,465,-465
3049,2019-10-04,Malta,0,Italy,2,2,0,Italy,Malta,1885,1189,696,-696
3050,2019-10-04,Spain,4,Azerbaijan,0,4,0,Spain,Azerbaijan,1897,1345,552,-552
3051,2019-10-04,Albania,0,Portugal,1,1,0,Portugal,Albania,1671,1321,350,-350
3052,2019-10-04,Latvia,1,Slovakia,2,2,1,Slovakia,Latvia,1502,1229,273,-273
3053,2019-10-04,Hungary,0,Sweden,5,5,0,Sweden,Hungary,2020,1524,496,-496
3054,2019-10-04,Lithuania,0,Switzerland,3,3,0,Switzerland,Lithuania,1815,1169,646,-646
3055,2019-10-04,Belarus,1,Norway,7,7,1,Norway,Belarus,1925,1451,474,-474
3056,2019-10-05,North Macedonia,0,Serbia,6,6,0,Serbia,North Macedonia,1556,1054,502,-502
3057,2019-10-05,Germany,8,Ukraine,0,8,0,Germany,Ukraine,2064,1703,361,-361
3058,2019-10-06,USA,1,Korea Republic,1,1,1,USA,Korea Republic,2180,1805,375,-375
3059,2019-10-08,Turkey,1,Slovenia,6,6,1,Slovenia,Turkey,1450,1391,59,-59
3060,2019-10-08,Estonia,1,Kosovo,2,2,1,Kosovo,Estonia,1080,1212,-132,132
3061,2019-10-08,Netherlands,2,Russia,0,2,0,Netherlands,Russia,2036,1708,328,-328
3062,2019-10-08,Italy,2,Bosnia and Herzegovina,0,2,0,Italy,Bosnia and Herzegovina,1885,1377,508,-508
3063,2019-10-08,Georgia,0,Denmark,2,2,0,Denmark,Georgia,1842,1143,699,-699
3064,2019-10-08,Czech Republic,1,Spain,5,5,1,Spain,Czech Republic,1897,1682,215,-215
3065,2019-10-08,Finland,8,Albania,1,8,1,Finland,Albania,1673,1321,352,-352
3066,2019-10-08,Sweden,7,Slovakia,0,7,0,Sweden,Slovakia,2020,1502,518,-518
3067,2019-10-08,Latvia,0,Iceland,6,6,0,Iceland,Latvia,1821,1229,592,-592
3068,2019-10-08,Kazakhstan,0,France,3,3,0,France,Kazakhstan,2031,1339,692,-692
3069,2019-10-08,Serbia,0,Austria,1,1,0,Austria,Serbia,1792,1556,236,-236
3070,2019-10-08,Romania,0,Belgium,1,1,0,Belgium,Romania,1817,1548,269,-269
3071,2019-10-08,Switzerland,2,Croatia,0,2,0,Switzerland,Croatia,1815,1442,373,-373
3072,2019-10-08,Greece,0,Germany,5,5,0,Germany,Greece,2064,1376,688,-688
3073,2019-10-08,Republic of Ireland,3,Ukraine,2,3,2,Republic of Ireland,Ukraine,1665,1703,-38,38
3074,2019-10-08,Faroe Islands,0,Norway,13,13,0,Norway,Faroe Islands,1925,1263,662,-662
3075,2019-10-08,Belarus,0,Wales,1,1,0,Wales,Belarus,1660,1451,209,-209
3076,2019-10-20,Moldova,3,Azerbaijan,1,3,1,Moldova,Azerbaijan,1216,1345,-129,129
3077,2019-11-08,USA,3,Sweden,2,3,2,USA,Sweden,2180,2020,160,-160
3078,2019-11-11,USA,6,Costa Rica,0,6,0,USA,Costa Rica,2180,1632,548,-548
3079,2019-12-20,Netherlands,4,Slovenia,1,4,1,Netherlands,Slovenia,2035,1467,568,-568
3080,2019-12-20,Italy,5,Malta,0,5,0,Italy,Malta,1882,1195,687,-687
3081,2019-12-20,Israel,1,Bosnia and Herzegovina,3,3,1,Bosnia and Herzegovina,Israel,1397,1371,26,-26
3082,2019-12-20,Denmark,14,Georgia,0,14,0,Denmark,Georgia,1839,1145,694,-694
3083,2019-12-20,Poland,0,Spain,0,0,0,Poland,Spain,1677,1900,-223,223
3084,2019-12-20,Portugal,1,Finland,1,1,1,Portugal,Finland,1667,1678,-11,11
3085,2019-12-20,Hungary,4,Latvia,0,4,0,Hungary,Latvia,1526,1223,303,-303
3086,2019-12-20,Austria,9,Kazakhstan,0,9,0,Austria,Kazakhstan,1797,1318,479,-479
3087,2019-12-20,Switzerland,6,Romania,0,6,0,Switzerland,Romania,1817,1542,275,-275
3088,2019-12-20,Belgium,6,Lithuania,0,6,0,Belgium,Lithuania,1824,1168,656,-656
3089,2019-12-20,Greece,1,Republic of Ireland,1,1,1,Greece,Republic of Ireland,1395,1665,-270,270
3090,2019-12-20,Northern Ireland,0,Wales,0,0,0,Northern Ireland,Wales,1433,1659,-226,226
3091,2020-01-29,USA,4,Haiti,0,4,0,USA,Haiti,2174,1368,806,-806
3092,2020-02-01,USA,8,Panama,0,8,0,USA,Panama,2174,1437,737,-737
3093,2020-02-04,USA,6,Costa Rica,0,6,0,USA,Costa Rica,2174,1630,544,-544
3094,2020-02-08,USA,4,Mexico,0,4,0,USA,Mexico,2174,1699,475,-475
3095,2020-02-10,USA,3,Canada,0,3,0,USA,Canada,2174,1958,216,-216
3096,2020-03-04,France,1,Canada,0,1,0,France,Canada,2033,1958,75,-75
3097,2020-03-04,Netherlands,0,Brazil,0,0,0,Netherlands,Brazil,2035,1956,79,-79
3098,2020-03-04,Denmark,1,Norway,2,2,1,Norway,Denmark,1929,1839,90,-90
3099,2020-03-04,Germany,1,Sweden,0,1,0,Germany,Sweden,2078,2022,56,-56
3100,2020-03-04,New Zealand,1,Belgium,1,1,1,New Zealand,Belgium,1760,1824,-64,64
3101,2020-03-04,Portugal,1,Italy,2,2,1,Italy,Portugal,1882,1667,215,-215
3102,2020-03-05,Spain,3,Japan,1,3,1,Spain,Japan,1900,1942,-42,42
3103,2020-03-05,USA,2,England,0,2,0,USA,England,2174,2001,173,-173
3104,2020-03-05,Croatia,1,Mexico,1,1,1,Croatia,Mexico,1439,1699,-260,260
3105,2020-03-05,Czech Republic,1,Finland,1,1,1,Czech Republic,Finland,1678,1678,0,0
3106,2020-03-06,Serbia,8,North Macedonia,1,8,1,Serbia,North Macedonia,1553,1073,480,-480
3107,2020-03-07,Canada,0,Netherlands,0,0,0,Canada,Netherlands,1958,2035,-77,77
3108,2020-03-07,France,1,Brazil,0,1,0,France,Brazil,2033,1956,77,-77
3109,2020-03-07,Sweden,1,Denmark,2,2,1,Denmark,Sweden,1839,2022,-183,183
3110,2020-03-07,Portugal,0,Belgium,1,1,0,Belgium,Portugal,1824,1667,157,-157
3111,2020-03-07,Germany,4,Norway,0,4,0,Germany,Norway,2078,1929,149,-149
3112,2020-03-07,New Zealand,0,Italy,3,3,0,Italy,New Zealand,1882,1760,122,-122
3113,2020-03-07,Portugal,0,Sweden,2,2,0,Sweden,Portugal,2022,1667,355,-355
3114,2020-03-08,Japan,0,England,1,1,0,England,Japan,2001,1942,59,-59
3115,2020-03-08,USA,1,Spain,0,1,0,USA,Spain,2174,1900,274,-274
3116,2020-03-08,Finland,2,Croatia,3,3,2,Croatia,Finland,1439,1678,-239,239
3117,2020-03-08,Mexico,2,Slovakia,2,2,2,Mexico,Slovakia,1699,1500,199,-199
3118,2020-03-10,Brazil,2,Canada,2,2,2,Brazil,Canada,1956,1958,-2,2
3119,2020-03-10,France,3,Netherlands,3,3,3,France,Netherlands,2033,2035,-2,2
3120,2020-03-10,Belgium,0,Denmark,4,4,0,Denmark,Belgium,1839,1824,15,-15
3121,2020-03-10,New Zealand,1,Norway,2,2,1,Norway,New Zealand,1929,1760,169,-169
3122,2020-03-11,England,0,Spain,1,1,0,Spain,England,1900,2001,-101,101
3123,2020-03-11,USA,3,Japan,1,3,1,USA,Japan,2174,1942,232,-232
3124,2020-03-11,Mexico,0,Czech Republic,0,0,0,Mexico,Czech Republic,1699,1678,21,-21
3125,2020-03-11,Slovakia,2,Finland,4,4,2,Finland,Slovakia,1678,1500,178,-178
3126,2020-05-20,Bosnia and Herzegovina,1,Israel,0,1,0,Bosnia and Herzegovina,Israel,1397,1371,26,-26
3127,2020-05-20,Malta,2,Georgia,1,2,1,Malta,Georgia,1195,1145,50,-50
3128,2020-05-20,Republic of Ireland,1,Greece,0,1,0,Republic of Ireland,Greece,1665,1395,270,-270
3129,2020-06-20,Kosovo,0,Russia,5,5,0,Russia,Kosovo,1708,1109,599,-599
3130,2020-07-20,Poland,5,Moldova,0,5,0,Poland,Moldova,1677,1229,448,-448
3131,2020-09-17,Bosnia and Herzegovina,0,Denmark,4,4,0,Denmark,Bosnia and Herzegovina,1851,1411,440,-440
3132,2020-09-17,Sweden,8,Hungary,0,8,0,Sweden,Hungary,2007,1537,470,-470
3133,2020-09-17,Iceland,9,Latvia,0,9,0,Iceland,Latvia,1817,1223,594,-594
3134,2020-09-18,Russia,0,Netherlands,1,1,0,Netherlands,Russia,2032,1708,324,-324
3135,2020-09-18,Kosovo,2,Estonia,0,2,0,Kosovo,Estonia,1104,1210,-106,106
3136,2020-09-18,Slovenia,3,Turkey,1,3,1,Slovenia,Turkey,1471,1365,106,-106
3137,2020-09-18,Czech Republic,0,Poland,0,0,0,Czech Republic,Poland,1678,1683,-5,5
3138,2020-09-18,Serbia,0,France,2,2,0,France,Serbia,2036,1558,478,-478
3139,2020-09-18,Belgium,6,Romania,1,6,1,Belgium,Romania,1819,1535,284,-284
3140,2020-09-18,Croatia,1,Switzerland,1,1,1,Croatia,Switzerland,1453,1815,-362,362
3141,2020-09-18,Montenegro,1,Ukraine,3,3,1,Ukraine,Montenegro,1692,1201,491,-491
3142,2020-09-18,Faroe Islands,0,Northern Ireland,6,6,0,Northern Ireland,Faroe Islands,1432,1259,173,-173
3143,2020-09-19,Moldova,0,Spain,9,9,0,Spain,Moldova,1915,1228,687,-687
3144,2020-09-19,Germany,3,Republic of Ireland,0,3,0,Germany,Republic of Ireland,2090,1666,424,-424
3145,2020-09-22,Estonia,0,Russia,3,3,0,Russia,Estonia,1708,1210,498,-498
3146,2020-09-22,Bosnia and Herzegovina,0,Italy,5,5,0,Italy,Bosnia and Herzegovina,1889,1411,478,-478
3147,2020-09-22,Malta,0,Denmark,8,8,0,Denmark,Malta,1851,1197,654,-654
3148,2020-09-22,Poland,0,Czech Republic,2,2,0,Czech Republic,Poland,1678,1683,-5,5
3149,2020-09-22,Latvia,0,Hungary,5,5,0,Hungary,Latvia,1537,1223,314,-314
3150,2020-09-22,Iceland,1,Sweden,1,1,1,Iceland,Sweden,1817,2007,-190,190
3151,2020-09-22,Kazakhstan,0,Austria,5,5,0,Austria,Kazakhstan,1792,1318,474,-474
3152,2020-09-22,North Macedonia,0,France,7,7,0,France,North Macedonia,2036,1072,964,-964
3153,2020-09-22,Romania,4,Croatia,1,4,1,Romania,Croatia,1535,1453,82,-82
3154,2020-09-22,Switzerland,2,Belgium,1,2,1,Switzerland,Belgium,1815,1819,-4,4
3155,2020-09-22,Montenegro,0,Germany,3,3,0,Germany,Montenegro,2090,1201,889,-889
3156,2020-09-22,Ukraine,4,Greece,0,4,0,Ukraine,Greece,1692,1396,296,-296
3157,2020-09-22,Norway,1,Wales,0,1,0,Norway,Wales,1930,1658,272,-272
3158,2020-09-22,Faroe Islands,0,Belarus,2,2,0,Belarus,Faroe Islands,1434,1259,175,-175
3159,2020-10-20,Kosovo,0,Slovenia,3,3,0,Slovenia,Kosovo,1471,1104,367,-367
3160,2020-10-20,Israel,4,Georgia,0,4,0,Israel,Georgia,1369,1138,231,-231
3161,2020-10-20,Malta,2,Bosnia and Herzegovina,3,3,2,Bosnia and Herzegovina,Malta,1411,1197,214,-214
3162,2020-10-21,Denmark,4,Israel,0,4,0,Denmark,Israel,1851,1369,482,-482
3163,2020-10-22,Sweden,7,Latvia,0,7,0,Sweden,Latvia,2007,1223,784,-784
3164,2020-10-22,Greece,1,Montenegro,0,1,0,Greece,Montenegro,1396,1201,195,-195
3165,2020-10-22,Wales,4,Faroe Islands,0,4,0,Wales,Faroe Islands,1658,1259,399,-399
3166,2020-10-23,Russia,1,Slovenia,0,1,0,Russia,Slovenia,1708,1471,237,-237
3167,2020-10-23,Turkey,0,Kosovo,0,0,0,Turkey,Kosovo,1365,1104,261,-261
3168,2020-10-23,Netherlands,7,Estonia,0,7,0,Netherlands,Estonia,2032,1210,822,-822
3169,2020-10-23,Poland,3,Azerbaijan,0,3,0,Poland,Azerbaijan,1683,1321,362,-362
3170,2020-10-23,Spain,4,Czech Republic,0,4,0,Spain,Czech Republic,1915,1678,237,-237
3171,2020-10-23,Cyprus,0,Portugal,3,3,0,Portugal,Cyprus,1659,1114,545,-545
3172,2020-10-23,Scotland,3,Albania,0,3,0,Scotland,Albania,1804,1325,479,-479
3173,2020-10-23,Hungary,1,Slovakia,2,2,1,Slovakia,Hungary,1501,1537,-36,36
3174,2020-10-23,France,11,North Macedonia,0,11,0,France,North Macedonia,2036,1072,964,-964
3175,2020-10-23,Lithuania,0,Romania,4,4,0,Romania,Lithuania,1535,1169,366,-366
3176,2020-10-23,Ukraine,1,Republic of Ireland,0,1,0,Ukraine,Republic of Ireland,1692,1666,26,-26
3177,2020-10-24,Serbia,4,Kazakhstan,1,4,1,Serbia,Kazakhstan,1558,1318,240,-240
3178,2020-10-27,Russia,4,Turkey,2,4,2,Russia,Turkey,1708,1365,343,-343
3179,2020-10-27,Kosovo,0,Netherlands,6,6,0,Netherlands,Kosovo,2032,1104,928,-928
3180,2020-10-27,Georgia,1,Israel,2,2,1,Israel,Georgia,1369,1138,231,-231
3181,2020-10-27,Italy,1,Denmark,3,3,1,Denmark,Italy,1851,1889,-38,38
3182,2020-10-27,Moldova,0,Poland,3,3,0,Poland,Moldova,1683,1228,455,-455
3183,2020-10-27,Czech Republic,3,Azerbaijan,0,3,0,Czech Republic,Azerbaijan,1678,1321,357,-357
3184,2020-10-27,Finland,1,Scotland,0,1,0,Finland,Scotland,1671,1804,-133,133
3185,2020-10-27,Portugal,1,Cyprus,0,1,0,Portugal,Cyprus,1659,1114,545,-545
3186,2020-10-27,Slovakia,2,Latvia,0,2,0,Slovakia,Latvia,1501,1223,278,-278
3187,2020-10-27,Sweden,2,Iceland,0,2,0,Sweden,Iceland,2007,1817,190,-190
3188,2020-10-27,Austria,0,France,0,0,0,Austria,France,1792,2036,-244,244
3189,2020-10-27,Romania,0,Switzerland,2,2,0,Switzerland,Romania,1815,1535,280,-280
3190,2020-10-27,Lithuania,0,Belgium,9,9,0,Belgium,Lithuania,1819,1169,650,-650
3191,2020-10-27,Greece,0,Ukraine,4,4,0,Ukraine,Greece,1692,1396,296,-296
3192,2020-10-27,Wales,0,Norway,1,1,0,Norway,Wales,1930,1658,272,-272
3193,2020-10-27,Belarus,0,Northern Ireland,1,1,0,Northern Ireland,Belarus,1432,1434,-2,2
3194,2020-11-20,Azerbaijan,0,Poland,5,5,0,Poland,Azerbaijan,1683,1321,362,-362
3195,2020-11-20,Cyprus,0,Albania,2,2,0,Albania,Cyprus,1325,1114,211,-211
3196,2020-11-20,Montenegro,0,Republic of Ireland,3,3,0,Republic of Ireland,Montenegro,1666,1201,465,-465
3197,2020-11-26,Georgia,0,Malta,4,4,0,Malta,Georgia,1197,1138,59,-59
3198,2020-11-26,Slovakia,1,Iceland,3,3,1,Iceland,Slovakia,1817,1501,316,-316
3199,2020-11-27,Netherlands,0,USA,2,2,0,USA,Netherlands,2181,2032,149,-149
3200,2020-11-27,Estonia,0,Turkey,4,4,0,Turkey,Estonia,1365,1210,155,-155
3201,2020-11-27,Russia,3,Kosovo,0,3,0,Russia,Kosovo,1708,1104,604,-604
3202,2020-11-27,Spain,10,Moldova,0,10,0,Spain,Moldova,1915,1228,687,-687
3203,2020-11-27,Albania,4,Cyprus,0,4,0,Albania,Cyprus,1325,1114,211,-211
3204,2020-11-27,Portugal,1,Scotland,0,1,0,Portugal,Scotland,1659,1804,-145,145
3205,2020-11-27,Kazakhstan,0,North Macedonia,3,3,0,North Macedonia,Kazakhstan,1072,1318,-246,246
3206,2020-11-27,France,3,Austria,0,3,0,France,Austria,2036,1792,244,-244
3207,2020-11-27,Croatia,1,Lithuania,0,1,0,Croatia,Lithuania,1453,1169,284,-284
3208,2020-11-27,Germany,6,Greece,0,6,0,Germany,Greece,2090,1396,694,-694
3209,2020-11-27,Northern Ireland,3,Belarus,2,3,2,Northern Ireland,Belarus,1432,1434,-2,2
3210,2020-12-01,Turkey,1,Russia,2,2,1,Russia,Turkey,1708,1365,343,-343
3211,2020-12-01,Slovenia,2,Estonia,0,2,0,Slovenia,Estonia,1471,1210,261,-261
3212,2020-12-01,Netherlands,6,Kosovo,0,6,0,Netherlands,Kosovo,2032,1104,928,-928
3213,2020-12-01,Georgia,0,Bosnia and Herzegovina,3,3,0,Bosnia and Herzegovina,Georgia,1411,1138,273,-273
3214,2020-12-01,Israel,0,Malta,2,2,0,Malta,Israel,1197,1369,-172,172
3215,2020-12-01,Denmark,0,Italy,0,0,0,Denmark,Italy,1851,1889,-38,38
3216,2020-12-01,Czech Republic,7,Moldova,0,7,0,Czech Republic,Moldova,1678,1228,450,-450
3217,2020-12-01,Portugal,1,Albania,0,1,0,Portugal,Albania,1659,1325,334,-334
3218,2020-12-01,Scotland,0,Finland,1,1,0,Finland,Scotland,1671,1804,-133,133
3219,2020-12-01,Hungary,0,Iceland,1,1,0,Iceland,Hungary,1817,1537,280,-280
3220,2020-12-01,Slovakia,0,Sweden,6,6,0,Sweden,Slovakia,2007,1501,506,-506
3221,2020-12-01,Austria,1,Serbia,0,1,0,Austria,Serbia,1792,1558,234,-234
3222,2020-12-01,France,12,Kazakhstan,0,12,0,France,Kazakhstan,2036,1318,718,-718
3223,2020-12-01,Belgium,4,Switzerland,0,4,0,Belgium,Switzerland,1819,1815,4,-4
3224,2020-12-01,Ukraine,2,Montenegro,1,2,1,Ukraine,Montenegro,1692,1201,491,-491
3225,2020-12-01,Republic of Ireland,1,Germany,3,3,1,Germany,Republic of Ireland,2090,1666,424,-424
3226,2020-12-01,Northern Ireland,5,Faroe Islands,1,5,1,Northern Ireland,Faroe Islands,1432,1259,173,-173
3227,2020-12-01,Wales,3,Belarus,0,3,0,Wales,Belarus,1658,1434,224,-224
3228,2021-01-19,USA,4,Colombia,0,4,0,USA,Colombia,2192,1700,492,-492
3229,2021-01-23,USA,6,Colombia,0,6,0,USA,Colombia,2192,1700,492,-492
3230,2021-02-18,Azerbaijan,0,Spain,13,13,0,Spain,Azerbaijan,1919,1319,600,-600
3231,2021-02-19,USA,1,Canada,0,1,0,USA,Canada,2192,1958,234,-234
3232,2021-02-19,Cyprus,0,Scotland,10,10,0,Scotland,Cyprus,1762,1113,649,-649
3233,2021-02-19,Finland,1,Portugal,0,1,0,Finland,Portugal,1701,1666,35,-35
3234,2021-02-22,USA,2,Brazil,0,2,0,USA,Brazil,2192,1958,234,-234
3235,2021-02-23,Estonia,0,Slovenia,9,9,0,Slovenia,Estonia,1476,1188,288,-288
3236,2021-02-23,Azerbaijan,1,Moldova,0,1,0,Azerbaijan,Moldova,1319,1224,95,-95
3237,2021-02-23,Spain,3,Poland,0,3,0,Spain,Poland,1919,1672,247,-247
3238,2021-02-23,Scotland,0,Portugal,2,2,0,Portugal,Scotland,1666,1762,-96,96
3239,2021-02-23,Cyprus,0,Finland,5,5,0,Finland,Cyprus,1701,1113,588,-588
3240,2021-02-23,Croatia,0,Romania,1,1,0,Romania,Croatia,1538,1454,84,-84
3241,2021-02-24,Italy,12,Israel,0,12,0,Italy,Israel,1877,1352,525,-525
3242,2021-02-25,USA,6,Argentina,0,6,0,USA,Argentina,2192,1659,533,-533
3243,2021-04-08,Argentina,0,Venezuela,0,0,0,Argentina,Venezuela,1659,1425,234,-234
3244,2021-04-09,Ukraine,1,Northern Ireland,2,2,1,Northern Ireland,Ukraine,1466,1702,-236,236
3245,2021-04-09,Portugal,0,Russia,1,1,0,Russia,Portugal,1706,1666,40,-40
3246,2021-04-09,Czech Republic,1,Switzerland,1,1,1,Czech Republic,Switzerland,1689,1808,-119,119
3247,2021-04-10,Sweden,1,USA,1,1,1,Sweden,USA,2009,2192,-183,183
3248,2021-04-11,Argentina,1,Venezuela,0,1,0,Argentina,Venezuela,1659,1425,234,-234
3249,2021-04-13,Northern Ireland,2,Ukraine,0,2,0,Northern Ireland,Ukraine,1466,1702,-236,236
3250,2021-04-13,Russia,0,Portugal,0,0,0,Russia,Portugal,1706,1666,40,-40
3251,2021-04-13,Switzerland,1,Czech Republic,1,1,1,Switzerland,Czech Republic,1808,1689,119,-119
3252,2021-04-14,France,0,USA,2,2,0,USA,France,2192,2032,160,-160
3253,2021-09-17,Mongolia,0,Korea Republic,12,12,0,Korea Republic,Mongolia,1810.89,1114,696.8900000000001,-696.8900000000001
3254,2021-09-18,Nepal,1,Philippines,2,2,1,Philippines,Nepal,1369,1200,169,-169
3255,2021-09-19,Bangladesh,0,Jordan,5,5,0,Jordan,Bangladesh,1390.91,1008,382.9100000000001,-382.9100000000001
3256,2021-09-19,Malaysia,0,Thailand,4,4,0,Thailand,Malaysia,1596,1238,358,-358
3257,2021-09-20,Uzbekistan,12,Mongolia,0,12,0,Uzbekistan,Mongolia,1537.27,1114,423.27,-423.27
3258,2021-09-21,Hong Kong,0,Nepal,0,0,0,Hong Kong,Nepal,1329,1200,129,-129
3259,2021-09-22,IR Iran,5,Bangladesh,0,5,0,IR Iran,Bangladesh,1350.56,1008,342.55999999999995,-342.55999999999995
3260,2021-09-22,Palestine,0,Malaysia,2,2,0,Malaysia,Palestine,1238,1131,107,-107
3261,2021-09-23,Maldives,0,Vietnam,16,16,0,Vietnam,Maldives,1657,966,691,-691
3262,2021-09-23,Uzbekistan,0,Korea Republic,4,4,0,Korea Republic,Uzbekistan,1810.89,1537.27,273.6200000000001,-273.6200000000001
3263,2021-09-24,Singapore,0,Indonesia,1,1,0,Indonesia,Singapore,1222,1089,133,-133
3264,2021-09-24,Philippines,2,Hong Kong,1,2,1,Philippines,Hong Kong,1369,1329,40,-40
3265,2021-09-25,Jordan,0,IR Iran,0,0,0,Jordan,IR Iran,1390.91,1350.56,40.350000000000136,-40.350000000000136
3266,2021-09-25,Palestine,0,Thailand,7,7,0,Thailand,Palestine,1596,1131,465,-465
3267,2021-09-26,Tajikistan,4,Maldives,0,4,0,Tajikistan,Maldives,1035,966,69,-69
3268,2021-09-27,Indonesia,1,Singapore,0,1,0,Indonesia,Singapore,1222,1089,133,-133
3269,2021-09-29,Tajikistan,0,Vietnam,7,7,0,Vietnam,Tajikistan,1657,1035,622,-622
3270,2021-10-18,Laos,0,Chinese Taipei,4,4,0,Chinese Taipei,Laos,1589,1273,316,-316
3271,2021-10-18,Myanmar,4,Lebanon,0,4,0,Myanmar,Lebanon,1511,964.2,546.8,-546.8
3272,2021-10-18,United Arab Emirates,2,Guam,1,2,1,United Arab Emirates,Guam,1201,1282,-81,81
3273,2021-10-18,Sierra Leone,0,Gambia,2,2,0,Gambia,Sierra Leone,1143,1132,11,-11
3274,2021-10-20,Uganda,2,Ethiopia,0,2,0,Uganda,Ethiopia,868,1151,-283,283
3275,2021-10-20,Kenya,8,South Sudan,0,8,0,Kenya,South Sudan,986,761.72,224.27999999999997,-224.27999999999997
3276,2021-10-20,Eritrea,0,Burundi,5,5,0,Burundi,Eritrea,519,NA,NA,NA
3277,2021-10-20,Malawi,1,Zambia,1,1,1,Malawi,Zambia,904,1230.56,-326.55999999999995,326.55999999999995
3278,2021-10-20,Tanzania,1,Namibia,2,2,1,Namibia,Tanzania,956,979,-23,23
3279,2021-10-20,Zimbabwe,3,Swaziland,1,3,1,Zimbabwe,Swaziland,1132,826,306,-306
3280,2021-10-20,Angola,1,Botswana,5,5,1,Botswana,Angola,879.86,1111,-231.14,231.14
3281,2021-10-20,Mozambique,0,South Africa,7,7,0,South Africa,Mozambique,1431.14,814,617.1400000000001,-617.1400000000001
3282,2021-10-20,Algeria,14,Sudan,0,14,0,Algeria,Sudan,1271,NA,NA,NA
3283,2021-10-20,Egypt,2,Tunisia,6,6,2,Tunisia,Egypt,1323.09,1256,67.08999999999992,-67.08999999999992
3284,2021-10-20,Congo,2,Gabon,1,2,1,Congo,Gabon,1178,1066,112,-112
3285,2021-10-20,Liberia,1,Senegal,2,2,1,Senegal,Liberia,1247,877,370,-370
3286,2021-10-20,Mali,2,Guinea,2,2,2,Mali,Guinea,1276,1077,199,-199
3287,2021-10-20,Burkina Faso,2,Benin,1,2,1,Burkina Faso,Benin,1062,1187,-125,125
3288,2021-10-20,Nigeria,2,Ghana,0,2,0,Nigeria,Ghana,1614.33,1403,211.32999999999993,-211.32999999999993
3289,2021-10-20,Niger,0,Côte d'Ivoire,9,9,0,Côte d'Ivoire,Niger,1392,891,501,-501
3290,2021-10-21,Bahrain,0,Laos,0,0,0,Bahrain,Laos,1274,1273,1,-1
3291,2021-10-21,Lebanon,1,United Arab Emirates,0,1,0,Lebanon,United Arab Emirates,964.2,1201,-236.79999999999995,236.79999999999995
3292,2021-10-21,Guam,0,Myanmar,8,8,0,Myanmar,Guam,1511,1282,229,-229
3293,2021-10-23,Kenya,7,South Sudan,1,7,1,Kenya,South Sudan,986,761.72,224.27999999999997,-224.27999999999997
3294,2021-10-23,Namibia,3,Tanzania,2,3,2,Namibia,Tanzania,956,979,-23,23
3295,2021-10-24,Bahrain,0,Chinese Taipei,2,2,0,Chinese Taipei,Bahrain,1589,1274,315,-315
3296,2021-10-24,Myanmar,2,United Arab Emirates,0,2,0,Myanmar,United Arab Emirates,1511,1201,310,-310
3297,2021-10-24,Guam,0,Lebanon,3,3,0,Lebanon,Guam,964.2,1282,-317.79999999999995,317.79999999999995
3298,2021-10-24,Benin,1,Burkina Faso,3,3,1,Burkina Faso,Benin,1062,1187,-125,125
3299,2021-10-24,Ghana,1,Nigeria,0,1,0,Ghana,Nigeria,1403,1614.33,-211.32999999999993,211.32999999999993
3300,2021-10-25,Gambia,1,Sierra Leone,1,1,1,Gambia,Sierra Leone,1143,1132,11,-11
3301,2021-10-25,Guinea,0,Mali,2,2,0,Mali,Guinea,1276,1077,199,-199
3302,2021-10-25,Côte d'Ivoire,11,Niger,0,11,0,Côte d'Ivoire,Niger,1392,891,501,-501
3303,2021-10-26,Ethiopia,2,Uganda,0,2,0,Ethiopia,Uganda,1151,868,283,-283
3304,2021-10-26,Burundi,1,Eritrea,0,1,0,Burundi,Eritrea,519,NA,NA,NA
3305,2021-10-26,Zambia,3,Malawi,2,3,2,Zambia,Malawi,1230.56,904,326.55999999999995,-326.55999999999995
3306,2021-10-26,Swaziland,0,Zimbabwe,3,3,0,Zimbabwe,Swaziland,1132,826,306,-306
3307,2021-10-26,Botswana,2,Angola,0,2,0,Botswana,Angola,879.86,1111,-231.14,231.14
3308,2021-10-26,South Africa,6,Mozambique,0,6,0,South Africa,Mozambique,1431.14,814,617.1400000000001,-617.1400000000001
3309,2021-10-26,Tunisia,1,Egypt,0,1,0,Tunisia,Egypt,1323.09,1256,67.08999999999992,-67.08999999999992
3310,2021-10-26,Gabon,1,Congo,0,1,0,Gabon,Congo,1066,1178,-112,112
3311,2021-10-26,Senegal,6,Liberia,0,6,0,Senegal,Liberia,1247,877,370,-370
3312,2022-01-20,China PR,4,Chinese Taipei,0,4,0,China PR,Chinese Taipei,1814.22,1591.76,222.46000000000004,-222.46000000000004
3313,2022-01-21,Australia,18,Indonesia,0,18,0,Australia,Indonesia,1933.8,1236.24,697.56,-697.56
3314,2022-01-21,Thailand,0,Philippines,1,1,0,Philippines,Thailand,1385.64,1603.53,-217.88999999999987,217.88999999999987
3315,2022-01-21,Japan,5,Myanmar,0,5,0,Japan,Myanmar,1911,1521.79,389.21000000000004,-389.21000000000004
3316,2022-01-21,Korea Republic,3,Vietnam,0,3,0,Korea Republic,Vietnam,1817.62,1659.17,158.44999999999982,-158.44999999999982
3317,2022-01-23,IR Iran,0,China PR,7,7,0,China PR,IR Iran,1814.22,1364.63,449.5899999999999,-449.5899999999999
3318,2022-01-24,Philippines,0,Australia,4,4,0,Australia,Philippines,1933.8,1385.64,548.1599999999999,-548.1599999999999
3319,2022-01-24,Indonesia,0,Thailand,4,4,0,Thailand,Indonesia,1603.53,1236.24,367.28999999999996,-367.28999999999996
3320,2022-01-24,Myanmar,0,Korea Republic,2,2,0,Korea Republic,Myanmar,1817.62,1521.79,295.8299999999999,-295.8299999999999
3321,2022-01-24,Vietnam,0,Japan,3,3,0,Japan,Vietnam,1911,1659.17,251.82999999999993,-251.82999999999993
3322,2022-01-26,Chinese Taipei,5,IR Iran,0,5,0,Chinese Taipei,IR Iran,1591.76,1364.63,227.12999999999988,-227.12999999999988
3323,2022-01-27,Australia,2,Thailand,1,2,1,Australia,Thailand,1933.8,1603.53,330.27,-330.27
3324,2022-01-27,Philippines,6,Indonesia,0,6,0,Philippines,Indonesia,1385.64,1236.24,149.4000000000001,-149.4000000000001
3325,2022-01-27,Japan,1,Korea Republic,1,1,1,Japan,Korea Republic,1911,1817.62,93.38000000000011,-93.38000000000011
3326,2022-01-27,Vietnam,2,Myanmar,2,2,2,Vietnam,Myanmar,1659.17,1521.79,137.3800000000001,-137.3800000000001
3327,2022-01-30,Australia,0,Korea Republic,1,1,0,Korea Republic,Australia,1817.62,1933.8,-116.18000000000006,116.18000000000006
3328,2022-01-30,Japan,7,Thailand,0,7,0,Japan,Thailand,1911,1603.53,307.47,-307.47
3329,2022-01-30,China PR,3,Vietnam,1,3,1,China PR,Vietnam,1814.22,1659.17,155.04999999999995,-155.04999999999995
3330,2022-01-30,Chinese Taipei,1,Philippines,1,1,1,Chinese Taipei,Philippines,1591.76,1385.64,206.1199999999999,-206.1199999999999
3331,2022-02-02,Thailand,0,Vietnam,2,2,0,Vietnam,Thailand,1659.17,1603.53,55.6400000000001,-55.6400000000001
3332,2022-02-03,Korea Republic,2,Philippines,0,2,0,Korea Republic,Philippines,1817.62,1385.64,431.9799999999998,-431.9799999999998
3333,2022-02-03,China PR,2,Japan,2,2,2,China PR,Japan,1814.22,1911,-96.77999999999997,96.77999999999997
3334,2022-02-04,Chinese Taipei,3,Thailand,0,3,0,Chinese Taipei,Thailand,1591.76,1603.53,-11.769999999999982,11.769999999999982
3335,2022-02-06,China PR,3,Korea Republic,2,3,2,China PR,Korea Republic,1814.22,1817.62,-3.3999999999998636,3.3999999999998636
3336,2022-02-06,Vietnam,2,Chinese Taipei,1,2,1,Vietnam,Chinese Taipei,1659.17,1591.76,67.41000000000008,-67.41000000000008
3337,2022-02-16,Brazil,1,Netherlands,1,1,1,Brazil,Netherlands,1976.86,2021.99,-45.13000000000011,45.13000000000011
3338,2022-02-16,France,5,Finland,0,5,0,France,Finland,2034.41,1685.94,348.47,-348.47
3339,2022-02-16,Denmark,0,Italy,1,1,0,Italy,Denmark,1872.97,1880.31,-7.339999999999918,7.339999999999918
3340,2022-02-16,Portugal,2,Norway,0,2,0,Portugal,Norway,1676.66,1930.44,-253.77999999999997,253.77999999999997
3341,2022-02-16,Burundi,6,Djibouti,1,6,1,Burundi,Djibouti,519,NA,NA,NA
3342,2022-02-16,Zambia,0,Namibia,0,0,0,Zambia,Namibia,1217.16,993.49,223.67000000000007,-223.67000000000007
3343,2022-02-16,Senegal,1,Mali,0,1,0,Senegal,Mali,1246.31,1275.4,-29.090000000000146,29.090000000000146
3344,2022-02-16,Guinea-Bissau,0,Burkina Faso,6,6,0,Burkina Faso,Guinea-Bissau,1062,NA,NA,NA
3345,2022-02-17,USA,0,Czech Republic,0,0,0,USA,Czech Republic,2109.09,1716.07,393.0200000000002,-393.0200000000002
3346,2022-02-17,Iceland,1,New Zealand,0,1,0,Iceland,New Zealand,1834.53,1752.47,82.05999999999995,-82.05999999999995
3347,2022-02-17,Togo,2,Gabon,1,2,1,Togo,Gabon,962,1079.87,-117.86999999999989,117.86999999999989
3348,2022-02-18,Zimbabwe,1,Botswana,3,3,1,Botswana,Zimbabwe,933.26,1132.9,-199.6400000000001,199.6400000000001
3349,2022-02-18,South Africa,2,Algeria,0,2,0,South Africa,Algeria,1423.37,1292.25,131.1199999999999,-131.1199999999999
3350,2022-02-18,Tunisia,5,Equatorial Guinea,0,5,0,Tunisia,Equatorial Guinea,1344.65,1349.96,-5.309999999999945,5.309999999999945
3351,2022-02-18,Cameroon,8,Gambia,0,8,0,Cameroon,Gambia,1443.41,1132.29,311.1200000000001,-311.1200000000001
3352,2022-02-18,Nigeria,2,Côte d'Ivoire,0,2,0,Nigeria,Côte d'Ivoire,1584.09,1392,192.08999999999992,-192.08999999999992
3353,2022-02-19,France,2,Brazil,1,2,1,France,Brazil,2034.41,1976.86,57.55000000000018,-57.55000000000018
3354,2022-02-19,Finland,0,Netherlands,3,3,0,Netherlands,Finland,2021.99,1685.94,336.04999999999995,-336.04999999999995
3355,2022-02-20,USA,5,New Zealand,0,5,0,USA,New Zealand,2109.09,1752.47,356.6200000000001,-356.6200000000001
3356,2022-02-20,Czech Republic,1,Iceland,2,2,1,Iceland,Czech Republic,1834.53,1716.07,118.46000000000004,-118.46000000000004
3357,2022-02-20,Italy,2,Norway,1,2,1,Italy,Norway,1872.97,1930.44,-57.47000000000003,57.47000000000003
3358,2022-02-20,Portugal,0,Sweden,4,4,0,Sweden,Portugal,2079.13,1676.66,402.47,-402.47
3359,2022-02-21,Burundi,5,Djibouti,0,5,0,Burundi,Djibouti,519,NA,NA,NA
3360,2022-02-22,Brazil,0,Finland,0,0,0,Brazil,Finland,1976.86,1685.94,290.91999999999985,-290.91999999999985
3361,2022-02-22,France,3,Netherlands,1,3,1,France,Netherlands,2034.41,2021.99,12.420000000000073,-12.420000000000073
3362,2022-02-22,Namibia,1,Zambia,1,1,1,Namibia,Zambia,993.49,1217.16,-223.67000000000007,223.67000000000007
3363,2022-02-22,Mali,1,Senegal,0,1,0,Mali,Senegal,1275.4,1246.31,29.090000000000146,-29.090000000000146
3364,2022-02-23,New Zealand,0,Czech Republic,0,0,0,New Zealand,Czech Republic,1752.47,1716.07,36.40000000000009,-36.40000000000009
3365,2022-02-23,USA,5,Iceland,0,5,0,USA,Iceland,2109.09,1834.53,274.5600000000002,-274.5600000000002
3366,2022-02-23,Sweden,1,Italy,1,1,1,Sweden,Italy,2079.13,1872.97,206.16000000000008,-206.16000000000008
3367,2022-02-23,Portugal,0,Norway,2,2,0,Norway,Portugal,1930.44,1676.66,253.77999999999997,-253.77999999999997
3368,2022-02-23,Botswana,0,Zimbabwe,2,2,0,Zimbabwe,Botswana,1132.9,933.26,199.6400000000001,-199.6400000000001
3369,2022-02-23,Algeria,1,South Africa,1,1,1,Algeria,South Africa,1292.25,1423.37,-131.1199999999999,131.1199999999999
3370,2022-02-23,Equatorial Guinea,3,Tunisia,2,3,2,Equatorial Guinea,Tunisia,1349.96,1344.65,5.309999999999945,-5.309999999999945
3371,2022-02-23,Gabon,1,Togo,2,2,1,Togo,Gabon,962,1079.87,-117.86999999999989,117.86999999999989
3372,2022-02-23,Gambia,1,Cameroon,2,2,1,Cameroon,Gambia,1443.41,1132.29,311.1200000000001,-311.1200000000001
3373,2022-02-23,Burkina Faso,1,Guinea-Bissau,0,1,0,Burkina Faso,Guinea-Bissau,1062,NA,NA,NA
3374,2022-02-23,Côte d'Ivoire,0,Nigeria,1,1,0,Nigeria,Côte d'Ivoire,1584.09,1392,192.08999999999992,-192.08999999999992
